41 41 41 41 41 41 41 41 41 41 41 41 41 41 41 41 41 41 41 41 41 41 41 41 41 41 41 41 41 41 41 41 41 41 41 41 41 41 41 41 41 41 41 41 41 41 41 41 41 41 41 41 41 41 41 41 41 41 41 41 41 41 41 41 41 41 41 41 41 41 41 41 41 41 41 41 41 41 41 41 41 41 41 41 41 41 41 41 41 41 41 41 41 41 41 41 41 41 41 41 
41 41 41 41 41 41 41 41 41 41 41 41 41 41 41 41 41 41 41 41 41 41 41 41 41 41 41 41 41 41 41 41 41 41 41 41 41 41 41 41 41 41 41 41 41 41 41 41 41 41 41 41 41 41 41 41 41 41 41 41 41 41 41 41 41 41 41 41 41 41 41 41 41 41 41 41 41 41 41 41 41 41 41 41 41 41 41 41 41 41 41 41 41 41 41 41 41 41 41 41 
41 41 41 41 41 41 41 41 41 41 41 41 41 41 41 41 41 41 41 41 41 41 41 41 41 41 41 41 41 41 41 41 41 41 41 41 41 41 41 41 41 41 41 41 41 41 41 41 41 41 41 41 41 41 41 41 41 41 41 41 41 41 41 41 41 41 41 41 41 41 41 41 41 41 41 41 41 41 41 41 41 41 41 41 41 41 41 41 41 41 41 41 41 41 41 41 41 41 41 41 
41 41 41 41 41 41 41 41 41 41 41 41 41 41 41 41 41 41 41 41 41 41 41 41 41 41 41 41 41 41 41 41 41 41 41 41 41 41 41 41 41 41 41 41 41 41 41 41 41 41 41 41 41 41 41 41 41 41 41 41 41 41 41 41 41 41 41 41 41 41 41 41 41 41 41 41 41 41 41 41 41 41 41 41 41 41 41 41 41 41 41 41 41 41 41 41 41 41 41 41 
41 41 41 41 41 41 41 41 41 41 41 41 41 41 41 41 41 41 41 41 41 41 41 41 41 41 41 41 41 41 41 41 41 41 41 41 41 41 41 41 41 41 41 41 41 41 41 41 41 41 41 41 41 41 41 41 41 41 41 41 41 41 41 41 41 41 41 41 41 41 41 41 41 41 41 41 41 41 41 41 41 41 41 41 41 41 41 41 41 41 41 41 41 41 41 41 41 41 41 41 
41 41 41 41 41 41 41 41 41 41 41 41 41 41 41 41 41 41 41 41 41 41 41 41 41 41 41 41 41 41 41 41 41 41 41 41 41 41 41 41 41 41 41 41 41 41 41 41 41 41 41 41 41 41 41 41 41 41 41 41 41 41 41 41 41 41 41 41 41 41 41 41 41 41 41 41 41 41 41 41 41 41 41 41 41 41 41 41 41 41 41 41 41 41 41 41 41 41 41 41 
41 41 41 41 41 41 41 41 41 41 41 41 41 41 41 41 41 41 41 41 41 41 41 41 41 41 41 41 41 41 41 41 41 41 41 41 41 41 41 41 41 41 41 41 41 41 41 41 41 41 41 41 41 41 41 41 41 41 41 41 41 41 41 41 41 41 41 41 41 41 41 41 41 41 41 41 41 41 41 41 41 41 41 41 41 41 41 41 41 41 41 41 41 41 41 41 41 41 41 41 
41 41 41 41 41 41 41 41 41 41 41 41 41 41 41 41 41 41 41 41 41 41 41 41 41 41 41 41 41 41 41 41 41 41 41 41 41 41 41 41 41 41 41 41 41 41 41 41 41 41 41 41 41 41 41 41 41 41 41 41 41 41 41 41 41 41 41 41 41 41 41 41 41 41 41 41 41 41 41 41 41 41 41 41 41 41 41 41 41 41 41 41 41 41 41 41 41 41 41 41 
41 41 41 41 41 41 41 41 41 41 41 41 41 41 41 41 41 41 41 41 41 40 41 41 41 41 41 41 41 41 41 41 41 40 40 41 41 41 41 41 41 41 41 41 41 41 41 41 41 41 41 41 41 41 41 41 41 41 41 41 41 41 41 41 41 41 41 41 41 41 41 41 41 41 41 41 41 41 41 41 41 41 41 41 41 41 41 41 41 41 41 41 41 41 41 41 41 41 41 41 
41 41 41 41 41 41 41 41 41 41 41 41 41 40 40 41 41 41 41 41 40 40 40 41 41 41 41 41 41 41 41 58 40 40 40 40 41 40 41 41 41 41 41 41 41 41 41 41 41 41 41 41 41 41 41 41 41 41 41 41 41 41 41 41 41 41 41 41 41 41 41 41 41 41 41 41 41 41 41 41 41 41 41 41 41 41 41 41 41 41 41 41 41 41 41 41 41 41 41 41 
41 41 41 41 41 41 41 41 41 41 41 41 40 40 40 40 41 41 40 40 61 54 60 40 59 40 40 40 40 40 59 40 61 54 60 59 40 40 40 41 41 41 41 41 41 41 41 41 41 41 41 41 41 41 41 41 41 41 41 41 41 41 41 41 41 41 41 41 41 41 41 41 41 41 41 41 41 41 41 41 41 41 41 41 41 41 41 41 41 41 41 41 41 41 41 41 41 41 41 41 
41 41 41 41 41 41 41 41 41 41 41 40 59 39 39 40 40 58 40 40 51 9 47 60 40 58 59 40 40 40 61 54 45 1 52 58 61 54 60 40 41 41 41 41 41 41 41 41 41 41 41 41 41 41 41 41 41 41 41 41 41 41 41 41 41 41 41 41 41 41 41 41 41 41 41 41 41 41 41 41 41 41 41 41 41 41 41 41 41 41 41 41 41 41 41 41 41 41 41 41 
41 41 41 41 41 41 41 41 41 41 40 40 61 54 54 54 60 61 54 54 45 2 10 46 60 61 54 54 60 61 45 1 6 1 52 61 45 9 46 60 59 41 41 41 41 41 41 41 41 41 41 41 41 41 41 41 41 41 41 41 41 41 41 41 41 41 41 41 41 41 41 41 41 41 41 41 41 41 41 41 41 41 41 41 41 41 41 41 41 41 41 41 41 41 41 41 41 41 41 41 
41 41 41 41 41 41 41 41 41 40 40 61 45 1 1 1 46 45 1 1 1 1 1 1 46 45 6 8 47 45 1 1 1 1 47 45 10 2 1 46 60 40 41 41 41 41 41 41 41 41 41 41 41 41 41 41 41 41 41 41 41 41 41 41 41 41 41 41 41 41 41 41 41 41 41 41 41 41 41 41 41 41 41 41 41 41 41 41 41 41 41 41 41 41 41 41 41 41 41 41 
41 41 41 41 41 41 41 41 40 59 61 45 3 6 1 1 1 1 1 1 1 6 1 1 1 1 2 9 1 1 1 1 1 1 1 1 1 7 1 1 46 60 40 41 41 41 41 41 41 41 41 41 41 41 41 41 41 41 41 41 41 41 41 41 41 41 41 41 41 41 41 41 41 41 41 41 40 40 40 40 40 59 40 40 40 40 41 41 41 41 41 41 41 41 41 41 41 41 41 41 
41 41 41 41 41 41 41 40 58 61 45 3 4 3 3 1 1 1 1 1 1 1 1 1 20 24 1 1 1 1 1 1 1 1 1 1 1 1 1 1 1 52 40 40 41 41 41 41 41 41 41 41 41 41 41 41 41 41 41 41 41 41 41 41 41 41 41 41 41 41 41 41 41 41 40 59 40 40 40 40 40 40 58 40 40 40 40 40 40 41 41 41 41 41 41 41 41 41 41 41 
41 41 41 41 41 41 59 40 61 45 3 4 9 4 3 10 1 1 1 1 1 1 1 1 17 35 1 1 1 1 1 3 2 4 1 1 1 1 1 1 1 52 58 40 41 41 41 41 41 41 41 41 41 41 41 41 41 41 41 41 41 41 41 41 41 41 41 41 41 41 41 41 40 40 40 40 61 54 54 54 54 54 54 54 54 60 40 40 40 40 41 41 41 41 41 41 41 41 41 41 
41 41 41 41 41 40 40 61 45 1 4 3 4 4 8 1 6 1 5 1 2 9 1 3 16 36 1 1 1 1 5 1 5 6 1 1 1 1 1 1 1 52 40 40 41 41 41 41 41 41 41 41 41 41 41 41 41 41 41 41 41 41 41 41 41 41 41 41 41 41 41 40 40 40 61 54 45 10 1 1 4 6 1 1 1 47 54 54 60 40 40 41 41 41 41 41 41 41 41 41 
41 41 41 41 40 40 61 45 1 1 4 6 3 8 2 7 8 3 1 1 10 8 1 1 16 35 1 1 1 1 3 3 3 5 29 1 1 1 1 10 1 47 60 40 41 41 41 41 41 41 41 41 41 41 41 41 41 41 41 41 41 41 41 41 41 41 41 41 41 41 40 40 61 54 45 4 1 1 1 1 1 8 5 1 1 1 1 2 47 60 40 40 41 41 41 41 41 41 41 41 
41 41 41 59 40 61 45 1 1 1 3 1 1 7 3 8 1 3 1 1 1 1 1 1 17 35 1 1 1 1 10 9 8 7 3 1 1 29 1 9 2 1 52 40 40 41 41 41 41 41 41 41 41 41 41 41 41 41 41 41 41 41 41 41 41 41 41 41 41 40 58 61 45 1 1 1 6 1 5 5 1 10 9 1 1 7 1 1 4 47 60 40 40 41 41 41 41 41 41 41 
41 41 40 40 39 51 1 1 1 1 1 20 24 1 5 4 3 9 1 1 4 3 1 1 19 35 8 6 1 1 2 7 7 1 6 1 1 1 1 1 1 1 47 60 59 41 41 41 41 41 41 41 41 41 41 41 41 41 41 41 41 41 41 41 41 41 41 41 40 40 61 45 1 1 1 1 2 1 1 1 1 2 4 1 1 1 5 1 1 1 47 60 40 40 41 41 41 41 41 41 
41 41 40 40 39 51 1 1 1 1 3 21 23 6 1 1 1 1 1 1 1 1 1 6 16 35 9 2 1 1 1 1 1 29 1 1 29 1 1 1 1 1 6 52 40 58 41 41 41 41 41 41 41 41 41 41 41 41 41 41 41 41 41 41 41 41 41 40 40 61 45 4 1 1 8 1 1 6 1 1 1 1 1 1 1 1 1 1 6 1 4 47 60 40 59 41 41 41 41 41 
41 41 40 40 59 51 1 1 1 1 29 5 3 5 20 34 31 32 31 31 31 34 31 31 11 30 31 31 31 31 32 31 24 1 1 1 1 1 29 1 1 57 53 63 40 41 41 41 41 41 41 41 41 41 41 41 41 41 41 41 41 41 41 41 41 41 40 40 61 45 1 1 10 1 5 1 1 1 1 5 1 1 6 1 1 1 1 1 1 9 8 1 47 60 40 40 41 41 41 41 
41 41 40 40 58 51 1 1 1 1 1 3 1 4 21 12 12 12 12 12 13 12 12 12 11 11 14 13 14 14 14 15 23 10 1 20 24 1 1 1 57 63 40 40 41 41 41 41 41 41 41 41 41 41 41 41 41 41 41 41 41 41 41 41 41 41 40 40 51 1 1 1 1 1 1 1 1 1 1 1 1 1 5 1 1 6 1 5 1 1 1 1 6 52 40 40 41 41 41 41 
41 41 41 40 40 62 43 1 1 29 1 6 3 5 3 1 1 4 1 1 1 1 1 1 16 35 1 3 1 4 3 3 1 1 1 16 36 1 1 57 63 59 40 41 41 41 41 41 41 41 41 41 41 41 41 41 41 41 41 41 41 41 41 41 41 41 40 40 51 1 1 6 1 5 1 1 7 1 1 1 7 1 1 10 1 1 1 1 1 1 1 1 1 52 40 40 41 41 41 41 
41 41 41 41 40 40 62 43 1 1 1 29 3 3 1 9 1 1 10 1 2 1 29 1 17 35 1 3 3 3 1 9 1 1 1 19 35 1 1 47 54 60 39 40 41 41 41 41 41 41 41 41 41 41 41 41 41 41 41 41 41 41 41 41 41 41 59 40 51 4 1 1 1 1 1 1 3 1 1 4 1 1 1 1 1 1 1 1 2 1 1 5 1 52 40 40 41 41 41 41 
41 41 41 41 41 40 40 62 43 1 1 1 20 24 1 1 1 4 3 1 20 24 1 1 16 35 1 3 1 1 1 1 1 1 20 11 23 6 1 1 1 46 54 60 40 41 41 41 41 41 41 41 41 41 41 41 41 41 41 41 41 41 41 41 41 41 40 40 51 1 8 1 1 1 1 1 1 1 1 1 1 1 1 1 1 1 1 1 1 1 1 1 7 52 40 40 41 41 41 41 
41 41 41 41 41 40 40 39 51 1 1 1 21 30 24 1 3 3 29 1 21 23 1 1 16 35 1 6 1 1 1 1 1 20 30 23 1 1 3 1 1 1 1 52 58 40 41 41 41 41 41 41 41 41 41 41 41 41 41 41 41 41 41 41 41 41 40 40 51 6 1 2 5 1 1 1 9 1 1 5 1 1 5 1 1 5 1 1 4 6 1 1 1 52 40 58 41 41 41 41 
41 41 41 41 41 41 58 40 62 43 9 1 1 21 11 24 1 1 1 1 1 1 1 1 16 35 1 1 8 1 1 1 20 11 23 5 1 1 10 9 1 1 57 63 40 41 41 41 41 41 41 41 41 41 41 41 41 41 41 41 41 41 41 41 41 41 40 40 51 1 1 1 1 3 1 1 10 2 1 7 1 1 1 1 1 8 1 1 1 1 1 5 1 52 40 40 41 41 41 41 
41 41 41 41 41 41 40 59 39 51 1 1 1 8 21 30 24 29 9 29 1 6 29 1 17 35 1 1 1 1 1 20 30 23 5 1 5 1 2 3 1 57 63 40 59 41 41 41 41 41 41 41 41 41 41 41 41 41 41 41 41 41 41 41 41 41 40 40 51 1 1 1 1 1 1 1 1 1 1 1 1 6 1 1 1 1 1 1 1 1 1 1 10 52 40 40 41 41 41 41 
41 41 41 41 41 41 41 40 39 62 43 6 1 1 3 21 11 24 1 2 1 5 1 1 16 35 1 1 1 1 20 11 23 1 9 6 1 1 1 1 1 52 39 40 40 41 41 41 41 41 41 41 41 41 41 41 41 41 41 41 41 41 41 41 41 41 40 59 51 1 1 6 1 1 8 1 4 1 1 1 4 1 1 1 1 1 4 1 1 1 1 1 6 52 40 40 41 41 41 41 
41 41 41 41 41 41 41 40 40 39 51 1 1 1 2 1 21 11 24 1 1 1 10 3 16 35 3 1 2 20 11 23 3 8 2 3 1 1 1 1 1 52 39 58 40 41 41 41 41 41 41 41 41 41 41 41 41 41 41 41 41 41 41 41 41 41 40 40 51 1 10 1 1 1 1 1 7 1 1 1 1 1 1 1 1 9 1 1 1 1 5 1 1 52 40 40 41 41 41 41 
41 41 41 41 41 41 41 41 40 40 62 43 1 1 1 1 1 21 30 24 3 3 3 1 16 35 1 1 20 30 23 4 4 10 7 3 1 1 1 1 6 52 39 40 40 41 41 41 41 41 41 41 41 41 41 41 41 41 41 41 41 41 41 41 41 41 40 40 62 43 4 1 1 1 1 1 1 5 1 1 1 1 1 5 2 10 1 1 1 1 7 1 1 52 40 40 41 41 41 41 
41 41 41 41 41 41 41 41 41 40 40 62 43 9 1 1 1 1 21 11 31 32 31 31 11 30 31 31 11 23 1 1 6 8 4 3 1 1 1 1 1 52 39 40 40 41 41 41 41 41 41 41 41 41 41 41 41 41 41 41 41 41 41 41 41 41 41 40 40 51 1 1 5 1 1 3 1 6 1 1 1 1 1 1 7 1 6 1 1 1 1 1 57 63 59 40 41 41 41 41 
41 41 41 41 41 41 41 41 41 41 40 58 62 43 1 1 1 10 1 21 12 12 12 13 12 12 12 13 23 1 1 1 1 1 3 10 9 1 1 57 53 63 40 40 41 41 41 41 41 41 41 41 41 41 41 41 41 41 41 41 41 41 41 41 41 41 41 41 40 62 43 1 2 1 1 1 1 5 1 1 1 5 1 1 1 5 1 1 1 1 57 53 63 40 40 41 41 41 41 41 
41 41 41 41 41 41 41 41 41 41 40 59 39 51 1 1 2 6 1 1 1 4 4 1 1 7 10 1 1 1 1 1 1 3 4 2 3 4 57 63 58 40 59 41 41 41 41 41 41 41 41 41 41 41 41 41 41 41 41 41 41 41 41 41 41 41 41 41 59 40 62 43 1 1 1 1 1 1 1 4 1 1 1 1 1 1 1 1 1 4 52 40 40 40 41 41 41 41 41 41 
41 41 41 41 41 41 41 41 41 41 41 40 40 62 53 53 43 7 1 1 8 9 1 1 1 1 8 57 53 53 43 1 4 4 1 1 1 57 63 40 40 40 41 41 41 41 41 41 41 41 41 41 41 41 41 41 41 41 41 41 41 41 41 41 41 41 41 41 41 40 40 62 43 4 1 9 8 1 1 1 1 1 1 1 1 10 1 1 1 57 63 40 40 41 41 41 41 41 41 41 
41 41 41 41 41 41 41 41 41 41 41 41 40 40 39 39 62 43 1 1 2 7 1 1 1 57 53 63 39 39 62 43 1 1 1 1 57 63 40 58 40 41 41 41 41 41 41 41 41 41 41 41 41 41 41 41 41 41 41 41 41 41 41 41 41 41 41 41 41 41 40 40 62 43 1 1 1 1 1 6 1 1 1 4 8 1 1 3 57 63 40 40 41 41 41 41 41 41 41 41 
41 41 41 41 41 41 41 41 41 41 41 41 41 40 58 40 40 62 43 1 1 6 1 1 57 63 39 40 40 59 40 62 43 6 1 57 63 40 59 41 41 41 41 41 41 41 41 41 41 41 41 41 41 41 41 41 41 41 41 41 41 41 41 41 41 41 41 41 41 41 41 40 40 62 53 43 1 1 4 1 2 1 1 1 1 4 57 53 63 40 40 41 41 41 41 41 41 41 41 41 
41 41 41 41 41 41 41 41 41 41 41 41 41 41 40 40 40 59 62 43 1 1 57 53 63 40 40 40 40 40 40 58 62 53 53 63 39 40 40 41 41 41 41 41 41 41 41 41 41 41 41 41 41 41 41 41 41 41 41 41 41 41 41 41 41 41 41 41 41 41 41 41 40 59 40 62 53 53 53 53 53 53 53 53 53 53 63 40 59 40 41 41 41 41 41 41 41 41 41 41 
41 41 41 41 41 41 41 41 41 41 41 41 41 41 41 41 41 58 40 62 53 53 63 39 40 40 40 41 41 41 41 40 40 39 39 39 40 40 41 41 41 41 41 41 41 41 41 41 41 41 41 41 41 41 41 41 41 41 41 41 41 41 41 41 41 41 41 41 41 41 41 41 41 40 40 40 40 40 40 40 40 40 40 40 40 40 40 40 40 41 41 41 41 41 41 41 41 41 41 41 
41 41 41 41 41 41 41 41 41 41 41 41 41 41 41 41 41 41 40 40 39 39 58 40 40 41 41 41 41 41 41 41 40 40 40 40 40 41 41 41 41 41 41 41 41 41 41 41 41 41 41 41 41 41 41 41 41 41 41 41 41 41 41 41 41 41 41 41 41 41 41 41 41 41 41 40 40 40 40 40 40 40 40 40 40 40 40 41 41 41 41 41 41 41 41 41 41 41 41 41 
41 41 41 41 41 41 41 41 41 41 41 41 41 41 41 41 41 41 41 40 40 40 40 59 41 41 41 41 41 41 41 41 41 59 40 40 41 41 41 41 41 41 41 41 41 41 41 41 41 41 41 41 41 41 41 41 41 41 41 41 41 41 41 41 41 41 41 41 41 41 41 41 41 41 41 41 41 41 41 41 41 41 41 41 41 41 41 41 41 41 41 41 41 41 41 41 41 41 41 41 
41 41 41 41 41 41 41 41 41 41 41 41 41 41 41 41 41 41 41 41 40 40 41 41 41 41 41 41 41 41 41 41 41 41 41 41 41 41 41 41 41 41 41 41 41 41 41 41 41 41 41 41 41 41 41 41 41 41 41 41 41 41 41 41 41 41 41 41 41 41 41 41 41 41 41 41 41 41 41 41 41 41 41 41 41 41 41 41 41 41 41 41 41 41 41 41 41 41 41 41 
41 41 41 41 41 41 41 41 41 41 41 41 41 41 41 41 41 41 41 41 41 41 41 41 41 41 41 41 41 41 41 41 41 41 41 41 41 41 41 41 41 41 41 41 41 41 41 41 41 41 41 41 41 41 41 41 41 41 41 41 41 41 41 41 41 41 41 41 41 41 41 41 41 41 41 41 41 41 41 41 41 41 41 41 41 41 41 41 41 41 41 41 41 41 41 41 41 41 41 41 
41 41 41 41 41 41 41 41 41 41 41 41 41 41 41 41 41 41 41 41 41 41 41 41 41 41 41 41 41 41 41 41 41 41 41 41 41 41 41 41 41 41 41 41 41 41 41 41 41 41 41 41 41 41 41 41 41 41 41 41 41 41 41 41 41 41 41 41 41 41 41 41 41 41 41 41 41 41 41 41 41 41 41 41 41 41 41 41 41 41 41 41 41 41 41 41 41 41 41 41 
41 41 41 41 41 41 41 41 41 41 41 41 41 41 41 41 41 41 41 41 41 41 41 41 41 41 41 41 41 41 41 41 41 41 41 41 41 41 41 41 41 41 41 41 41 41 41 41 41 41 41 41 41 41 41 41 41 41 41 41 41 41 41 41 41 41 41 41 41 41 41 41 41 41 41 41 41 41 41 41 41 41 41 41 41 41 41 41 41 41 41 41 41 41 41 41 41 41 41 41 
41 41 41 41 41 41 41 41 41 41 41 41 41 41 41 41 41 41 41 41 41 41 41 41 41 41 41 41 41 41 41 41 41 41 41 41 41 41 41 41 41 41 41 41 41 41 41 41 41 41 41 41 41 41 41 41 41 41 41 41 41 41 41 41 41 41 41 41 41 41 41 41 41 41 41 41 41 41 41 41 41 41 41 41 41 41 41 41 41 41 41 41 41 41 41 41 41 41 41 41 
41 41 41 41 41 41 41 41 41 41 41 41 41 41 41 41 41 41 41 41 41 41 41 41 41 41 41 41 41 41 41 41 41 41 41 41 41 41 41 41 41 41 41 41 41 41 41 41 41 41 41 41 41 41 41 41 41 41 41 41 41 41 41 41 41 41 41 41 41 41 41 41 41 41 41 41 41 41 41 41 41 41 41 41 41 41 41 41 41 41 41 41 41 41 41 41 41 41 41 41 
41 41 41 41 41 41 41 41 41 41 41 41 41 41 41 41 41 41 41 41 41 41 41 41 41 41 41 41 41 41 41 41 41 41 41 41 41 41 41 41 41 41 41 41 41 41 41 41 41 41 41 41 41 41 41 41 41 41 41 41 41 41 41 41 41 41 41 41 41 41 41 41 41 41 41 41 41 41 41 41 41 41 41 41 41 41 41 41 41 41 41 41 41 41 41 41 41 41 41 41 
41 41 41 41 41 41 41 41 41 41 41 41 41 41 41 41 41 41 41 41 41 41 41 41 41 41 41 41 41 41 41 41 41 41 41 41 41 41 41 41 41 41 41 41 41 41 41 41 41 41 41 41 41 41 41 41 41 41 41 41 41 41 41 41 41 41 41 41 41 41 41 41 41 41 41 41 41 41 41 41 41 41 41 41 41 41 41 41 41 41 41 41 41 41 41 41 41 41 41 41 
41 41 41 41 41 41 41 41 41 41 41 41 41 41 41 41 41 41 41 41 41 41 41 41 41 41 41 41 41 41 41 41 41 41 41 41 41 41 41 41 41 41 41 41 41 41 41 41 41 41 41 41 41 41 41 41 41 41 41 41 41 41 41 41 41 41 41 41 41 41 41 41 41 41 41 41 41 41 41 41 41 41 41 41 41 41 41 41 41 41 41 41 41 41 41 41 41 41 41 41 
41 41 41 41 41 41 41 41 41 41 41 41 41 41 41 41 41 41 41 41 41 41 41 41 41 41 41 41 41 41 41 41 41 41 41 41 41 41 41 41 41 41 41 41 41 41 41 41 41 41 41 41 41 41 41 41 41 41 41 41 41 41 41 41 41 41 41 41 41 41 41 41 41 41 41 41 41 41 41 41 41 41 41 41 41 41 41 41 41 41 41 41 41 41 41 41 41 41 41 41 
41 41 41 41 41 41 41 41 41 41 41 41 41 41 41 41 41 41 41 41 41 41 41 41 41 41 41 41 41 41 41 41 41 41 41 41 41 41 41 41 41 41 41 41 41 41 41 41 41 41 41 41 41 41 41 41 41 41 41 41 41 41 41 41 41 41 41 41 41 41 41 41 41 41 41 41 41 41 41 41 41 41 41 41 41 41 41 41 41 41 41 41 41 41 41 41 41 41 41 41 
41 41 41 41 41 41 41 41 41 41 41 41 41 41 41 41 41 41 41 41 41 41 41 41 41 41 41 41 41 41 41 41 41 41 41 41 41 41 41 41 41 41 41 41 41 41 41 41 41 41 41 41 41 41 41 41 41 41 41 41 41 41 41 41 41 41 41 41 41 41 41 41 41 41 41 41 41 41 41 41 41 41 41 41 41 41 41 41 41 41 41 41 41 41 41 41 41 41 41 41 
41 41 41 41 41 41 41 41 41 41 41 41 41 41 41 41 41 41 41 41 41 41 41 41 41 41 41 41 41 41 41 41 41 41 41 41 41 41 41 41 41 41 41 41 41 41 41 41 41 41 41 41 41 41 41 41 41 41 41 41 41 41 41 41 41 41 41 41 41 41 41 41 41 41 41 41 41 41 41 41 41 41 40 40 40 40 40 40 40 40 59 41 41 41 41 41 41 41 41 41 
41 41 41 41 41 41 41 41 41 41 41 41 41 41 41 41 41 41 41 41 41 41 41 41 41 41 41 41 41 41 41 41 41 41 41 41 41 41 41 41 41 41 41 41 41 41 41 41 41 41 41 41 41 41 41 41 41 41 41 41 41 41 41 41 41 41 41 41 41 41 41 41 41 41 41 41 41 41 41 41 41 40 59 40 40 40 40 40 40 40 40 40 40 40 41 41 41 41 41 41 
41 41 41 41 41 41 41 41 41 41 41 41 41 41 41 41 41 41 41 41 41 41 41 41 41 41 41 41 41 41 41 41 41 41 41 41 41 41 41 41 41 41 41 41 41 41 41 41 41 41 41 41 41 41 41 41 41 41 41 41 41 41 41 41 41 41 41 41 41 41 41 41 41 41 41 41 41 41 41 41 40 40 61 54 54 54 54 54 54 54 60 40 40 40 59 40 40 41 41 41 
41 41 41 41 41 41 41 41 41 41 41 41 41 41 41 41 41 41 41 41 41 41 41 41 41 41 41 41 41 41 41 41 41 41 41 41 41 41 41 41 41 41 41 41 41 41 41 41 41 41 41 41 41 41 41 41 41 41 41 41 41 41 41 41 41 41 41 41 41 41 41 41 41 41 41 41 41 41 41 40 40 61 45 1 4 1 1 9 3 1 47 54 54 60 40 58 40 40 41 41 
41 41 41 41 41 41 41 41 41 41 41 41 41 41 41 41 41 41 41 41 41 41 41 41 41 41 41 41 41 41 41 41 41 41 41 41 41 41 41 41 41 41 41 41 41 41 41 41 41 41 41 41 41 41 41 41 41 41 41 41 41 41 41 41 41 41 41 41 41 41 41 41 41 41 41 41 41 41 40 40 61 45 6 1 1 1 1 8 1 1 6 1 1 47 54 60 40 40 40 41 
41 41 41 41 41 41 41 41 41 41 41 41 41 41 41 41 41 40 40 40 40 40 40 40 59 40 40 40 40 40 40 58 41 41 41 41 41 41 41 41 41 41 41 41 41 41 41 41 41 41 41 41 41 41 41 41 41 41 41 41 41 41 41 41 41 41 41 41 41 41 41 41 41 41 41 41 41 40 58 61 45 3 2 1 1 1 1 1 1 1 1 4 1 1 1 47 60 40 40 41 
41 41 41 41 41 41 41 41 41 41 41 41 41 41 41 41 40 40 40 58 40 40 40 40 40 40 40 40 40 40 40 40 59 41 41 41 41 41 41 41 41 41 41 41 41 41 41 41 41 41 41 41 41 41 41 41 41 41 41 41 41 41 41 41 41 41 41 41 41 41 41 41 41 41 41 41 40 40 61 45 1 7 1 1 1 1 1 5 1 1 1 1 1 7 1 1 52 40 40 41 
41 41 41 41 41 41 41 41 41 41 41 41 41 41 41 40 40 61 54 54 54 54 54 54 54 54 54 54 54 54 54 60 40 40 40 41 41 41 41 41 41 41 41 41 41 41 41 41 41 41 41 41 41 41 41 41 41 41 41 41 41 41 41 41 41 41 41 41 41 41 41 41 41 41 41 41 40 40 51 1 1 1 1 1 3 1 1 1 1 1 1 1 1 2 1 1 52 40 40 41 
41 41 41 41 41 41 41 41 41 41 41 41 41 41 40 40 61 45 5 1 1 1 1 4 1 1 1 10 1 1 1 46 60 40 40 40 40 41 41 41 41 41 41 41 41 41 41 41 41 41 41 41 41 41 41 41 41 41 41 41 41 41 41 41 41 41 41 41 41 41 41 41 41 41 41 41 40 59 51 1 1 1 1 1 1 1 6 1 1 1 3 1 1 1 1 1 52 40 40 40 
41 41 41 41 41 41 41 41 41 41 41 41 41 40 40 61 45 9 1 1 1 1 1 1 8 1 1 1 1 1 1 1 46 54 60 40 40 40 41 41 41 41 41 41 41 41 41 41 41 41 41 41 41 41 41 41 41 41 41 41 41 41 41 41 41 41 41 41 41 41 41 41 41 41 41 40 40 61 45 4 1 1 1 1 1 1 1 1 1 1 7 1 1 1 1 1 47 54 60 40 
41 41 41 41 41 41 41 41 41 41 41 41 40 59 61 45 3 1 1 1 1 1 1 1 1 1 5 1 4 1 1 1 1 1 46 54 60 59 40 41 41 41 41 41 41 41 41 41 41 41 41 41 41 41 41 41 41 41 41 41 41 41 41 41 41 41 41 41 41 41 41 41 41 41 41 40 40 51 9 1 1 1 1 5 1 1 1 1 1 1 1 1 1 5 1 1 1 7 52 40 
41 41 41 41 41 41 41 41 41 41 41 40 40 61 45 1 1 1 1 1 1 1 1 3 1 1 1 7 1 29 1 1 1 7 1 1 46 60 40 40 41 41 41 41 41 41 41 41 41 41 41 41 41 41 41 41 41 41 41 41 41 41 41 41 41 41 41 41 41 41 41 41 41 41 41 40 40 51 1 6 1 1 1 1 1 1 4 1 1 1 1 1 1 1 1 1 1 1 52 59 
41 41 41 41 41 41 41 41 41 41 40 40 61 45 1 1 29 1 1 1 1 7 1 1 1 1 1 1 1 1 1 1 5 1 1 1 1 46 60 40 40 41 41 41 41 41 41 41 41 41 41 41 41 41 41 41 41 41 41 41 41 41 41 41 41 41 41 41 41 41 41 41 41 41 41 40 40 51 1 3 1 1 1 1 1 8 9 1 1 20 24 1 1 1 1 1 1 3 52 40 
41 41 41 41 41 41 41 41 41 40 40 61 45 1 1 1 1 1 5 10 9 1 1 1 1 1 1 1 1 1 1 1 10 1 1 1 1 1 46 60 40 40 41 41 41 41 41 41 41 41 41 41 41 41 41 41 41 41 41 41 41 41 41 41 41 41 41 41 41 41 41 41 41 41 41 40 40 51 1 1 1 1 1 1 1 2 10 6 1 21 23 1 3 1 6 1 1 1 52 58 
41 41 41 41 41 41 41 41 40 40 61 45 1 1 1 1 1 1 1 7 2 1 3 1 1 1 1 1 1 1 1 1 1 1 1 8 1 1 1 46 60 40 40 41 41 41 41 41 41 41 41 41 41 41 41 41 41 41 41 41 41 41 41 41 41 41 41 41 41 41 41 41 41 41 41 40 40 51 1 1 1 1 4 5 1 1 3 1 1 1 1 9 1 1 1 1 1 1 52 40 
41 41 41 41 41 41 41 59 40 61 45 1 4 1 1 1 3 1 1 1 1 1 1 1 1 5 1 1 1 1 3 1 1 1 1 1 1 1 1 9 46 60 40 58 41 41 41 41 41 41 41 41 41 41 41 41 41 41 41 41 41 41 41 41 41 41 41 41 41 41 41 41 41 41 41 59 40 51 4 1 1 1 1 1 1 1 1 1 1 1 2 10 1 1 1 5 1 1 52 40 
41 41 41 41 41 41 41 58 40 51 1 1 1 1 1 1 1 1 1 1 1 1 1 1 1 1 1 1 1 1 1 1 1 1 1 1 1 1 1 1 1 52 40 59 41 41 41 41 41 41 41 41 41 41 41 41 41 41 41 41 41 41 41 41 41 41 41 41 41 41 41 41 41 41 41 40 40 51 2 7 1 1 1 1 1 1 1 1 1 1 4 3 1 1 1 8 1 9 52 40 
41 41 41 41 41 41 41 40 40 51 1 29 1 1 1 1 1 1 1 1 1 1 1 1 1 1 1 1 1 1 1 1 1 1 1 1 29 1 1 5 1 52 40 40 41 41 41 41 41 41 41 41 41 41 41 41 41 41 41 41 41 41 41 41 41 41 41 41 41 41 41 41 41 41 41 40 40 62 43 1 1 1 1 1 3 1 1 1 1 1 1 1 1 1 1 1 1 1 52 40 
41 41 41 41 41 41 41 40 40 51 1 1 1 1 1 1 3 1 1 1 4 1 1 1 1 1 1 1 1 1 1 3 1 1 4 1 1 1 7 1 1 52 40 40 41 41 41 41 41 41 41 41 41 41 41 41 41 41 41 41 41 41 41 41 41 41 41 41 41 41 41 41 41 41 41 41 40 58 51 3 1 1 4 1 1 6 1 5 1 1 1 1 1 1 1 1 1 57 63 40 
41 41 41 41 41 41 41 40 40 51 9 1 1 5 1 1 1 1 1 1 1 1 1 1 1 9 1 1 5 1 1 1 1 7 1 1 1 1 1 1 1 52 40 40 41 41 41 41 41 41 41 41 41 41 41 41 41 41 41 41 41 41 41 41 41 41 41 41 41 41 41 41 41 41 41 41 40 40 62 53 43 1 1 1 1 1 1 1 1 1 1 1 4 1 1 57 53 63 40 40 
41 41 41 41 41 41 41 40 40 51 1 1 1 8 1 1 1 1 1 1 1 1 1 5 1 1 8 1 1 1 1 1 1 5 1 1 1 1 1 1 4 52 40 40 41 41 41 41 41 41 41 41 41 41 41 41 41 41 41 41 41 41 41 41 41 41 41 41 41 41 41 41 41 41 41 41 41 40 40 40 62 53 43 1 1 1 1 1 8 1 1 2 6 1 57 63 59 40 40 41 
41 41 41 41 41 41 41 40 59 51 1 1 5 1 1 1 5 1 1 1 1 1 1 1 1 1 1 1 1 1 4 1 1 1 1 1 1 3 1 1 1 52 40 58 41 41 41 41 41 41 41 41 41 41 41 41 41 41 41 41 41 41 41 41 41 41 41 41 41 41 41 41 41 41 41 41 41 41 40 40 40 59 62 43 10 9 1 1 1 3 1 1 1 57 63 40 40 40 41 41 
41 41 41 41 41 41 41 40 40 51 1 1 1 1 1 1 1 1 1 1 1 1 1 1 1 29 1 1 1 1 1 1 1 1 1 1 1 1 1 1 10 52 59 40 41 41 41 41 41 41 41 41 41 41 41 41 41 41 41 41 41 41 41 41 41 41 41 41 41 41 41 41 41 41 41 41 41 41 41 41 40 40 40 62 53 53 53 53 53 53 53 53 53 63 40 40 40 41 41 41 
41 41 41 41 41 41 41 40 40 51 1 1 10 1 3 1 1 1 1 5 1 1 3 1 1 1 1 1 1 1 1 1 1 1 3 1 1 1 1 1 1 52 40 40 41 41 41 41 41 41 41 41 41 41 41 41 41 41 41 41 41 41 41 41 41 41 41 41 41 41 41 41 41 41 41 41 41 41 41 41 41 40 40 40 40 40 59 40 40 40 40 40 40 40 40 40 41 41 41 41 
41 41 41 41 41 41 41 40 40 51 1 1 1 1 1 1 20 24 1 1 1 7 1 1 1 1 1 1 1 1 1 1 1 1 1 1 1 1 1 1 7 52 40 40 41 41 41 41 41 41 41 41 41 41 41 41 41 41 41 41 41 41 41 41 41 41 41 41 41 41 41 41 41 41 41 41 41 41 41 41 41 41 58 40 40 40 40 40 40 40 40 40 58 40 40 41 41 41 41 41 
41 41 41 41 41 41 41 40 40 51 1 1 1 1 1 1 21 23 1 1 4 1 1 1 1 1 1 3 1 1 1 1 3 1 1 1 5 1 1 1 1 52 40 40 41 41 41 41 41 41 41 41 41 41 41 41 41 41 41 41 41 41 41 41 41 41 41 41 41 41 41 41 41 41 41 41 41 41 41 41 41 41 41 41 41 41 41 41 41 41 41 41 41 41 41 41 41 41 41 41 
41 41 41 41 41 41 41 40 40 51 1 7 5 1 1 1 1 1 1 1 1 1 1 1 1 1 5 7 1 1 1 1 1 1 1 1 29 1 1 1 5 52 40 40 41 41 41 41 41 41 41 41 41 41 41 41 41 41 41 41 41 41 41 41 41 41 41 41 41 41 41 41 41 41 41 41 41 41 41 41 41 41 41 41 41 41 41 41 41 41 41 41 41 41 41 41 41 41 41 41 
41 41 41 41 41 41 41 40 40 51 1 1 1 1 1 1 1 1 1 1 9 1 1 1 1 1 4 1 1 1 1 1 1 1 1 1 1 1 1 1 1 52 40 40 41 41 41 41 41 41 41 41 41 41 41 41 41 41 41 41 41 41 41 41 41 41 41 41 41 41 41 41 41 41 41 41 41 41 41 41 41 41 41 41 41 41 41 41 41 41 41 41 41 41 41 41 41 41 41 41 
41 41 41 41 41 41 41 40 58 62 43 1 1 1 1 1 1 5 1 1 5 1 1 1 1 1 1 1 1 1 3 1 10 1 8 1 1 1 1 1 57 63 40 59 41 41 41 41 41 41 41 41 41 41 41 41 41 41 41 41 41 41 41 41 41 41 41 41 41 41 41 41 41 41 41 41 41 41 41 41 41 41 41 41 41 41 41 41 41 41 41 41 41 41 41 41 41 41 41 41 
41 41 41 41 41 41 41 41 40 59 62 43 1 1 3 1 1 1 1 1 1 1 1 1 1 1 1 1 1 1 1 1 5 1 4 1 1 1 1 57 63 40 58 41 41 41 41 41 41 41 41 41 41 41 41 41 41 41 41 41 41 41 41 41 41 41 41 41 41 41 41 41 41 41 41 41 41 41 41 41 41 41 41 41 41 41 41 41 41 41 41 41 41 41 41 41 41 41 41 41 
41 41 41 41 41 41 41 41 41 40 40 62 43 1 1 1 1 1 4 1 8 1 1 1 1 1 1 5 1 1 1 1 1 1 1 1 1 5 57 63 40 40 41 41 41 41 41 41 41 41 41 41 41 41 41 41 41 41 41 41 41 41 41 41 41 41 41 41 41 41 41 41 41 41 41 41 41 41 41 41 41 41 41 41 41 41 41 41 41 41 41 41 41 41 41 41 41 41 41 41 
41 41 41 41 41 41 41 41 41 41 40 40 62 43 1 1 1 1 1 1 1 3 1 1 1 1 1 1 1 1 1 1 1 1 1 1 1 57 63 40 40 41 41 41 41 41 41 41 41 41 41 41 41 41 41 41 41 41 41 41 41 41 41 41 41 41 41 41 41 41 41 41 41 41 41 41 41 41 41 41 41 41 41 41 41 41 41 41 41 41 41 41 41 41 41 41 41 41 41 41 
41 41 41 41 41 41 41 41 41 41 41 40 40 62 43 1 1 1 1 1 1 1 1 1 1 1 1 1 1 3 1 1 1 3 1 1 57 63 40 40 41 41 41 41 41 41 41 41 41 41 41 41 41 41 41 41 41 41 41 41 41 41 41 41 41 41 41 41 41 41 41 41 41 41 41 41 41 41 41 41 41 41 41 41 41 41 41 41 41 41 41 41 41 41 41 41 41 41 41 41 
41 41 41 41 41 41 41 41 41 41 41 41 40 40 62 43 1 5 1 1 1 1 1 5 29 1 1 1 1 1 1 1 1 1 1 57 63 58 40 41 41 41 41 41 41 41 41 41 41 41 41 41 41 41 41 41 41 41 41 41 41 41 41 41 41 41 41 41 41 41 41 41 41 41 41 41 41 41 41 41 41 41 41 41 41 41 41 41 41 41 41 41 41 41 41 41 41 41 41 41 
41 41 41 41 41 41 41 41 41 41 41 41 41 40 40 62 43 1 10 1 1 1 1 1 1 4 1 8 1 1 5 1 1 1 57 63 40 40 41 41 41 41 41 41 41 41 41 41 41 41 41 41 41 41 41 41 41 41 41 41 41 41 41 41 41 41 41 41 41 41 41 41 41 41 41 41 41 41 41 41 41 41 41 41 41 41 41 41 41 41 41 41 41 41 41 41 41 41 41 41 
41 41 41 41 41 41 41 41 41 41 41 41 41 41 40 58 62 43 1 1 1 1 1 1 1 1 1 1 1 1 1 1 1 57 63 40 40 41 41 41 41 41 41 41 41 41 41 41 41 41 41 41 41 41 41 41 41 41 41 41 41 41 41 41 41 41 41 41 41 41 41 41 41 41 41 41 41 41 41 41 41 41 41 41 41 41 41 41 41 41 41 41 41 41 41 41 41 41 41 41 
41 41 41 41 41 41 41 41 41 41 41 41 41 41 41 40 40 62 43 1 1 7 1 1 1 1 1 9 1 1 1 1 57 63 40 40 41 41 41 41 41 41 41 41 41 41 41 41 41 41 41 41 41 41 41 41 41 41 41 41 41 41 41 41 41 41 41 41 41 41 41 41 41 41 41 41 41 41 41 41 41 41 41 41 41 41 41 41 41 41 41 41 41 41 41 41 41 41 41 41 
41 41 41 41 41 41 41 41 41 41 41 41 41 41 41 41 40 40 62 53 53 53 53 53 53 53 53 53 53 53 53 53 63 40 40 41 41 41 41 41 41 41 41 41 41 41 41 41 41 41 41 41 41 41 41 41 41 41 41 41 41 41 41 41 41 41 41 41 41 41 41 41 41 41 41 41 41 41 41 41 41 41 41 41 41 41 41 41 41 41 41 41 41 41 41 41 41 41 41 41 
41 41 41 41 41 41 41 41 41 41 41 41 41 41 41 41 41 40 40 40 59 40 40 40 40 59 40 40 40 40 40 40 40 40 41 41 41 41 41 41 41 41 41 41 41 41 41 41 41 41 41 41 41 41 41 41 41 41 41 41 41 41 41 41 41 41 41 41 41 41 41 41 41 41 41 41 41 41 41 41 41 41 41 41 41 41 41 41 41 41 41 41 41 41 41 41 41 41 41 41 
41 41 41 41 41 41 41 41 41 41 41 41 41 41 41 41 41 41 40 40 40 40 40 40 40 40 58 40 40 40 40 40 59 41 41 41 41 41 41 41 41 41 41 41 41 41 41 41 41 41 41 41 41 41 41 41 41 41 41 41 41 41 41 41 41 41 41 41 41 41 41 41 41 41 41 41 41 41 41 41 41 41 41 41 41 41 41 41 41 41 41 41 41 41 41 41 41 41 41 41 
41 41 41 41 41 41 41 41 41 41 41 41 41 41 41 41 41 41 41 41 41 41 41 41 41 41 41 41 41 41 41 41 41 41 41 41 41 41 41 41 41 41 41 41 41 41 41 41 41 41 41 41 41 41 41 41 41 41 41 41 41 41 41 41 41 41 41 41 41 41 41 41 41 41 41 41 41 41 41 41 41 41 41 41 41 41 41 41 41 41 41 41 41 41 41 41 41 41 41 41 
41 41 41 41 41 41 41 41 41 41 41 41 41 41 41 41 41 41 41 41 41 41 41 41 41 41 41 41 41 41 41 41 41 41 41 41 41 41 41 41 41 41 41 41 41 41 41 41 41 41 41 41 41 41 41 41 41 41 41 41 41 41 41 41 41 41 41 41 41 41 41 41 41 41 41 41 41 41 41 41 41 41 41 41 41 41 41 41 41 41 41 41 41 41 41 41 41 41 41 41 
41 41 41 41 41 41 41 41 41 41 41 41 41 41 41 41 41 41 41 41 41 41 41 41 41 41 41 41 41 41 41 41 41 41 41 41 41 41 41 41 41 41 41 41 41 41 41 41 41 41 41 41 41 41 41 41 41 41 41 41 41 41 41 41 41 41 41 41 41 41 41 41 41 41 41 41 41 41 41 41 41 41 41 41 41 41 41 41 41 41 41 41 41 41 41 41 41 41 41 41 
41 41 41 41 41 41 41 41 41 41 41 41 41 41 41 41 41 41 41 41 41 41 41 41 41 41 41 41 41 41 41 41 41 41 41 41 41 41 41 41 41 41 41 41 41 41 41 41 41 41 41 41 41 41 41 41 41 41 41 41 41 41 41 41 41 41 41 41 41 41 41 41 41 41 41 41 41 41 41 41 41 41 41 41 41 41 41 41 41 41 41 41 41 41 41 41 41 41 41 41 
41 41 41 41 41 41 41 41 41 41 41 41 41 41 41 41 41 41 41 41 41 41 41 41 41 41 41 41 41 41 41 41 41 41 41 41 41 41 41 41 41 41 41 41 41 41 41 41 41 41 41 41 41 41 41 41 41 41 41 41 41 41 41 41 41 41 41 41 41 41 41 41 41 41 41 41 41 41 41 41 41 41 41 41 41 41 41 41 41 41 41 41 41 41 41 41 41 41 41 41 
