3 0 9 3 5 0 3 39 0 3 5 9 3 1 0 3 0 8 0 4 5 0 4 0 0 7 0 0 0 0 6 0 0 8 0 2 9 0 2 0 0 0 1 0 9 0 0 0 0 0 
3 7 6 4 4 8 4 4 1 4 8 4 4 4 1 7 4 5 4 8 4 4 8 1 4 0 7 0 4 9 0 8 2 0 0 2 0 5 0 2 0 0 0 0 4 0 0 0 0 0 
1 4 8 19 33 31 30 31 33 32 33 32 33 32 32 31 30 31 30 23 0 0 0 5 7 4 0 8 0 6 0 4 0 2 6 0 8 0 2 0 0 8 0 4 0 0 0 0 0 0 
30 30 31 10 21 21 21 21 10 21 21 21 10 10 21 21 10 10 29 10 30 30 33 33 30 30 30 30 30 30 30 30 30 30 30 30 30 30 23 2 0 0 0 4 8 0 4 9 0 0 
21 21 10 21 21 21 11 11 11 14 11 14 14 11 14 14 10 10 29 10 10 29 10 29 10 10 10 10 10 10 10 10 10 10 10 10 10 10 10 30 23 4 0 0 8 0 4 0 0 0 
12 11 11 12 12 22 4 9 7 4 4 4 4 9 4 1 20 12 12 11 14 11 14 12 11 11 11 11 11 11 11 11 11 11 11 11 10 10 10 10 34 0 9 0 0 4 4 0 0 0 
2 4 4 4 4 9 4 4 4 4 4 7 4 4 4 2 5 5 9 2 0 2 36 9 0 0 4 0 2 9 0 4 0 9 0 1 20 11 21 10 10 23 0 0 4 0 0 1 0 0 
2 4 4 6 4 4 7 4 4 4 9 4 4 1 4 4 0 1 4 0 1 0 2 0 4 7 0 0 8 0 0 6 4 0 4 0 5 4 15 10 10 34 0 8 4 0 0 0 0 0 
5 3 3 5 3 0 8 0 2 3 4 5 37 3 9 5 2 8 0 2 5 9 0 7 5 0 4 0 2 0 9 4 0 8 4 0 9 4 20 21 10 34 0 0 0 8 2 0 0 0 
0 0 0 0 0 0 0 0 0 0 0 0 0 0 0 0 0 0 0 0 0 0 0 0 0 0 0 0 0 0 0 0 0 0 0 4 0 4 0 15 10 34 0 4 0 0 2 0 0 0 
0 0 0 0 0 0 0 0 0 0 0 0 0 0 0 0 0 0 0 0 0 0 0 0 0 0 0 0 0 0 0 0 1 0 3 0 1 0 0 15 10 34 0 9 0 0 0 9 0 0 
0 0 0 0 0 0 0 0 0 0 0 0 0 0 0 0 0 0 0 0 0 0 0 0 0 0 0 0 0 0 0 0 0 0 0 0 0 4 19 21 10 34 0 0 0 4 0 0 0 0 
0 0 0 0 0 0 0 0 0 0 0 0 0 0 0 0 0 0 0 0 0 0 0 0 0 0 0 0 0 0 0 0 0 4 0 3 0 19 21 10 10 34 0 0 8 0 0 0 0 0 
4 4 4 4 4 0 0 0 0 0 0 0 0 0 0 0 0 0 0 0 0 2 0 7 0 0 0 7 0 4 8 0 0 1 0 7 0 15 10 10 21 22 0 7 0 0 8 0 0 0 
0 0 0 0 4 0 0 7 0 0 8 4 4 0 0 5 4 1 4 0 0 9 2 0 0 1 0 0 8 9 0 4 1 2 2 0 19 21 10 21 22 0 0 8 0 0 0 0 0 0 
0 0 0 4 0 0 4 4 1 0 4 0 0 1 4 4 4 7 0 4 2 0 0 9 2 0 7 4 0 0 8 0 2 2 0 19 21 10 10 34 0 0 2 0 0 0 0 0 0 0 
0 7 4 4 0 0 0 4 4 0 4 8 4 0 4 0 8 1 0 4 0 1 0 9 0 0 0 19 30 32 33 32 33 32 33 21 10 10 21 22 7 2 2 0 4 1 0 0 0 0 
0 0 4 4 1 0 7 0 4 0 4 0 4 7 4 0 7 0 0 4 9 0 2 0 1 19 30 21 10 10 21 10 10 10 10 10 10 21 22 0 2 2 0 0 4 0 0 0 0 0 
4 8 0 4 4 0 0 8 4 1 0 0 4 5 19 30 30 30 23 4 4 2 0 19 30 21 10 10 10 10 11 11 11 11 11 11 11 22 0 0 0 0 0 7 4 0 0 0 0 0 
0 0 0 7 4 4 19 30 32 32 32 32 32 33 21 10 10 10 10 23 0 19 30 21 10 10 10 21 11 22 4 9 7 0 0 0 4 8 0 0 7 0 4 0 4 0 0 0 0 0 
1 0 4 0 0 19 21 10 10 10 10 10 10 10 10 10 11 10 10 10 31 21 10 10 10 21 12 22 2 0 2 8 0 0 9 0 4 0 0 0 0 0 0 0 4 0 0 0 0 0 
4 4 0 8 19 21 10 10 21 11 11 11 11 11 11 22 1 20 21 10 10 10 10 21 12 22 0 9 0 7 9 0 0 8 0 0 4 0 0 4 0 4 0 0 0 3 3 0 0 0 
4 8 1 19 21 10 10 21 22 0 0 4 8 0 0 0 0 0 20 11 11 11 11 22 0 0 0 0 0 0 0 0 0 0 0 0 0 0 0 0 0 0 0 3 3 3 0 0 0 0 
0 0 0 16 10 10 21 22 0 0 6 4 4 0 0 4 0 4 4 4 0 8 0 4 4 6 0 0 0 8 0 0 0 0 0 0 0 0 0 0 0 0 3 3 0 0 0 0 0 0 
7 4 8 16 10 21 22 8 4 4 0 8 4 4 0 4 6 0 4 4 0 4 0 0 4 0 0 0 0 0 0 6 0 0 0 0 0 0 0 0 0 0 3 0 0 0 0 0 0 0 
4 4 0 16 10 35 0 19 32 32 32 30 23 0 0 0 0 4 8 4 4 4 8 0 4 8 0 0 19 30 30 30 30 30 23 0 0 0 0 8 0 0 3 0 0 0 0 0 0 0 
0 4 4 16 10 10 30 21 10 10 10 10 21 23 0 6 0 4 0 4 0 0 8 0 4 0 19 30 21 10 10 10 10 10 21 23 0 0 0 0 0 0 3 3 0 8 0 0 0 0 
1 1 0 20 21 10 10 10 10 21 21 10 10 21 32 23 0 4 8 0 6 0 0 4 4 19 21 10 10 10 21 11 21 10 10 21 30 30 30 23 0 0 0 3 3 0 0 0 0 0 
0 0 7 0 20 11 11 11 11 22 20 29 10 10 10 21 23 0 0 0 0 0 0 19 30 21 10 10 21 11 22 0 20 21 10 10 10 10 10 21 23 0 0 8 0 3 3 0 0 0 
8 0 0 4 0 4 4 4 4 0 0 20 11 29 10 10 21 32 31 31 23 0 19 21 10 10 10 21 22 0 0 0 0 20 11 11 11 21 10 10 35 0 0 8 0 0 3 3 3 0 
0 0 1 0 0 8 0 4 4 7 0 0 0 20 11 29 10 10 10 10 21 32 10 10 10 21 11 22 0 3 3 8 3 0 0 0 0 17 21 10 35 0 0 0 0 8 0 0 3 0 
4 0 1 0 0 0 4 4 0 0 0 0 4 0 0 20 11 11 29 10 10 10 10 21 11 22 0 0 0 0 0 0 0 0 0 0 19 10 10 10 34 0 0 0 0 0 0 3 3 0 
0 4 0 0 4 4 0 0 1 0 0 4 4 0 0 0 0 0 20 11 11 11 11 22 0 0 3 3 3 8 3 3 3 0 0 19 10 10 21 12 22 0 0 0 0 0 3 3 0 0 
0 4 4 4 0 0 0 0 0 0 4 4 0 8 0 0 3 3 3 3 3 3 0 0 0 0 3 0 3 3 3 3 8 0 19 10 10 21 22 0 3 0 0 0 0 3 3 3 0 0 
0 0 0 4 4 4 0 0 0 0 0 0 0 0 0 0 3 3 3 3 0 0 0 8 0 0 0 3 3 0 0 0 0 19 21 10 21 22 0 3 3 0 3 0 0 0 0 3 3 0 
0 0 0 0 0 0 0 0 0 0 0 0 3 0 0 0 0 0 0 3 3 0 0 0 0 0 0 0 0 8 0 19 32 21 10 10 35 3 3 0 8 0 3 3 0 8 0 0 3 0 
0 0 0 0 0 0 0 0 0 0 0 0 3 0 0 8 0 0 3 0 0 0 0 0 0 0 0 19 32 32 32 21 10 10 10 21 22 0 0 0 0 0 0 3 3 0 0 0 3 0 
0 0 0 3 3 0 0 0 0 0 8 0 3 3 0 0 0 3 3 0 0 8 0 0 0 19 32 21 10 10 10 10 10 21 12 22 0 3 3 3 0 0 0 0 3 3 3 3 3 0 
0 0 0 3 0 0 0 3 0 0 0 0 0 3 0 0 0 3 0 19 30 30 30 30 30 21 10 10 10 21 12 12 12 22 0 0 3 3 0 3 3 0 0 8 0 0 3 3 0 0 
0 0 3 3 0 0 0 3 0 3 3 3 3 3 3 0 0 19 30 21 10 10 10 10 21 10 10 21 12 22 0 0 0 0 0 0 3 0 8 0 3 0 0 0 0 0 0 0 0 0 
0 0 3 0 0 0 3 0 0 3 0 0 0 3 0 0 19 21 10 10 10 21 21 10 10 10 21 22 0 3 3 3 0 0 0 3 3 0 0 0 3 3 0 0 0 0 0 0 0 0 
0 0 3 3 0 0 3 0 0 0 0 0 3 3 0 19 21 10 10 21 11 22 20 11 11 11 22 0 0 3 0 0 0 0 3 3 0 0 0 0 0 3 3 3 3 3 3 3 3 0 
0 0 0 3 3 0 3 0 0 3 0 0 3 0 0 16 10 10 21 22 0 0 0 0 0 3 3 3 3 3 0 0 0 0 3 0 0 0 3 3 3 3 0 3 3 3 0 0 3 3 
0 0 0 0 3 3 3 0 0 3 0 8 3 3 0 16 10 21 22 0 0 3 3 8 0 3 0 0 0 3 3 0 8 0 3 3 3 3 3 0 0 3 3 0 0 0 0 0 0 3 
0 0 0 0 3 3 3 0 0 3 0 0 0 3 0 16 10 35 0 0 0 3 3 0 3 3 0 8 0 0 3 0 0 0 0 0 0 0 0 8 0 3 0 0 8 0 0 0 3 3 
0 0 3 3 3 0 3 0 0 0 0 3 3 0 0 16 10 21 31 23 0 0 3 3 3 0 0 0 3 3 0 0 0 0 0 0 0 0 0 0 0 3 3 3 0 3 3 3 3 0 
0 0 3 0 0 0 3 0 0 0 3 3 0 8 0 16 10 10 10 21 31 31 23 0 0 0 0 0 3 0 0 19 30 30 30 30 30 30 23 0 3 3 0 3 3 3 0 0 8 0 
0 0 3 3 0 0 3 0 0 0 3 0 0 0 0 20 11 21 10 10 10 10 21 31 31 31 31 31 31 31 31 21 10 10 10 10 10 10 21 31 31 31 31 31 31 31 31 31 31 31 
0 0 0 3 0 0 0 0 0 0 3 3 0 0 8 0 0 20 11 11 21 10 10 10 10 10 10 10 10 10 10 10 10 21 11 11 11 21 10 10 10 10 10 10 10 10 10 10 10 10 
0 0 3 3 0 0 0 0 0 0 0 3 3 0 0 3 3 3 3 0 20 11 11 11 11 11 11 11 11 11 11 11 11 22 0 0 0 20 11 11 11 11 11 11 11 11 11 11 11 11 