40 40 40 40 40 40 40 40 40 40 40 40 40 40 40 40 40 40 40 40 40 40 40 40 40 40 40 40 40 40 40 40 40 40 40 40 40 40 40 40 40 40 40 40 40 40 40 40 40 40 40 40 40 40 40 40 40 40 40 40 40 40 40 40 40 40 40 40 40 40 40 40 40 40 40 40 40 40 40 40 40 40 40 40 40 40 40 40 40 40 40 40 40 40 40 40 40 40 40 40 
40 40 40 40 40 40 40 40 40 40 40 40 40 40 40 40 40 40 40 40 40 40 40 40 40 40 40 40 40 40 40 40 40 40 40 40 40 40 40 40 40 40 40 40 40 40 40 40 40 40 40 40 40 40 40 40 40 40 40 40 40 40 40 40 40 40 40 40 40 40 40 40 40 40 40 40 40 40 40 40 40 40 40 40 40 40 40 40 40 40 40 40 40 40 40 40 40 40 40 40 
40 40 40 40 40 40 40 40 40 40 40 40 40 40 40 40 40 40 40 40 40 40 40 40 40 40 40 40 40 40 40 40 40 40 40 40 40 40 40 40 40 40 40 40 40 40 40 40 40 40 40 40 40 40 40 40 40 40 40 40 40 40 40 40 40 40 40 40 40 40 40 40 40 40 40 40 40 40 40 40 40 40 40 40 40 40 40 40 40 40 40 40 40 40 40 40 40 40 40 40 
40 40 40 40 40 40 40 40 40 40 40 40 40 40 40 40 40 40 40 40 40 40 40 40 40 40 40 40 40 40 40 40 40 40 40 40 40 40 40 40 40 40 40 40 40 40 40 40 40 40 40 40 40 40 40 40 40 40 40 40 40 40 40 40 40 40 40 40 40 40 40 40 40 40 40 40 40 40 40 40 40 40 40 40 40 40 40 40 40 40 40 40 40 40 40 40 40 40 40 40 
40 40 40 40 40 40 40 40 40 40 40 40 40 40 40 40 40 40 40 40 40 40 40 40 40 40 40 40 40 40 40 40 40 40 40 40 40 40 40 40 40 40 40 40 40 40 40 40 40 40 40 40 40 40 40 40 40 40 40 40 40 40 40 40 40 40 40 40 40 40 40 40 40 40 40 40 40 40 40 40 40 40 40 40 40 40 40 40 40 40 40 40 40 40 40 40 40 40 40 40 
40 40 40 40 40 40 40 40 40 40 40 40 40 40 40 40 40 40 40 40 40 40 40 40 40 40 40 40 40 40 40 40 40 40 40 40 40 40 40 40 40 40 40 40 40 40 40 40 40 40 40 40 40 40 40 40 40 40 40 40 40 40 40 40 40 40 40 40 40 40 40 40 40 40 40 40 40 40 40 40 40 40 40 40 40 40 40 40 40 40 40 40 40 40 40 40 40 40 40 40 
40 40 40 40 40 40 40 40 40 40 40 40 40 40 40 40 40 40 40 40 40 40 40 40 40 40 40 40 40 40 40 40 40 40 40 40 40 40 40 40 40 40 40 40 40 40 40 40 40 40 40 40 40 40 40 40 40 40 40 40 40 40 40 40 40 40 40 40 40 40 40 40 40 40 40 40 40 40 40 40 40 40 40 40 40 40 40 40 40 40 40 40 40 40 40 40 40 40 40 40 
40 40 40 40 40 40 40 40 40 40 40 40 40 40 40 40 40 40 40 40 40 40 40 40 40 40 40 40 40 40 40 40 40 40 40 40 40 40 40 40 40 40 40 40 40 40 40 40 40 40 40 40 40 40 40 40 40 40 40 40 40 40 40 40 40 40 40 40 40 40 40 40 40 40 40 40 40 40 40 40 40 40 40 40 40 40 40 40 40 40 40 40 40 40 40 40 40 40 40 40 
40 40 40 40 40 40 40 40 40 40 40 40 40 40 40 40 40 40 40 40 40 40 40 40 40 40 40 40 40 40 40 40 40 40 40 40 40 40 40 40 40 40 40 40 40 40 40 40 40 40 40 40 40 40 40 40 40 40 40 40 40 40 40 40 40 40 40 59 40 40 40 40 40 40 40 40 40 40 40 40 40 40 40 40 40 40 40 40 40 40 40 40 40 40 40 40 40 40 40 40 
40 40 40 40 40 40 40 40 40 40 40 40 40 40 40 40 40 40 40 40 40 40 40 40 40 40 40 40 40 40 40 40 40 40 40 40 40 40 40 40 40 40 40 40 40 40 40 40 40 40 40 40 40 40 40 40 40 40 40 40 40 40 40 40 40 40 40 40 40 40 40 40 40 40 40 40 40 40 40 40 40 40 40 40 40 40 40 40 40 40 40 40 40 40 40 40 40 40 40 40 
40 40 40 40 40 40 40 40 40 40 40 40 40 40 40 40 40 40 40 40 40 40 40 40 40 40 40 40 40 40 40 40 40 40 40 40 40 40 40 40 40 40 40 40 40 40 40 40 40 40 40 40 40 40 40 40 40 40 59 40 40 40 40 40 40 40 40 40 40 40 40 59 40 40 40 40 40 40 40 40 40 40 40 40 40 40 40 40 40 40 40 40 40 40 40 40 40 40 40 40 
40 40 40 40 40 40 40 40 40 40 40 40 40 40 40 40 40 40 40 40 40 40 40 40 40 40 40 40 40 40 40 40 40 40 40 40 40 40 40 40 40 40 40 40 40 40 40 40 40 40 40 40 40 40 40 40 40 40 40 40 40 40 40 40 40 40 40 40 40 40 40 40 59 40 40 40 40 40 40 40 40 40 40 40 40 40 40 40 40 40 40 40 40 40 40 40 40 40 40 40 
40 40 40 40 40 40 40 40 40 40 40 40 40 40 40 40 40 40 40 40 40 40 40 40 40 40 40 40 40 40 40 40 40 40 40 40 40 40 40 40 40 40 40 40 40 40 40 40 40 40 40 40 40 40 40 40 40 40 40 40 58 40 40 40 40 40 40 40 40 40 40 40 40 40 58 40 40 40 40 40 40 59 40 40 58 40 40 40 40 40 40 40 40 40 40 40 40 40 40 40 
40 40 40 40 40 40 40 40 40 40 40 40 40 40 40 40 40 40 40 40 40 40 40 40 40 40 40 40 40 40 40 40 40 40 40 40 40 40 40 40 40 40 40 40 40 40 40 40 40 40 40 40 40 40 40 40 40 40 40 40 40 40 40 40 40 40 40 40 40 40 40 40 40 40 40 40 40 40 40 40 40 40 40 40 40 40 40 40 40 40 40 40 40 40 40 40 40 40 40 40 
40 40 40 40 40 40 40 40 40 40 40 40 40 40 40 40 40 40 40 40 40 40 40 40 40 40 40 40 40 40 40 40 40 40 40 40 40 40 40 40 40 40 40 40 40 40 40 40 40 40 40 58 40 40 40 40 40 40 40 40 40 40 40 40 40 40 40 40 40 40 40 40 40 40 40 40 40 40 40 40 40 40 40 40 40 40 40 40 40 40 40 40 40 40 40 40 40 40 40 40 
40 40 40 40 40 40 40 40 40 40 40 40 40 40 40 40 40 40 40 40 40 40 40 40 40 40 40 40 40 40 40 40 40 40 40 40 40 40 40 40 40 40 40 40 40 40 40 40 40 40 40 40 40 40 40 40 40 40 40 40 59 40 40 40 40 40 40 40 39 39 39 39 39 39 39 40 59 40 40 40 40 40 40 40 40 40 40 40 40 40 40 40 40 40 40 40 40 40 40 40 
40 40 40 40 40 40 40 40 40 40 40 40 40 40 40 40 40 40 40 40 40 40 40 40 40 40 40 40 40 40 40 40 40 40 40 40 40 40 40 40 40 40 40 40 40 40 40 40 40 40 40 40 40 40 40 40 40 39 39 39 39 39 39 39 39 58 39 39 39 39 39 39 39 39 39 58 39 39 39 39 39 39 39 40 40 40 40 40 40 40 40 40 40 40 40 40 40 40 40 40 
40 40 40 40 40 40 40 40 40 40 40 40 40 40 40 40 40 40 40 40 40 40 40 40 40 40 40 40 40 40 40 40 40 40 40 40 40 40 40 40 40 40 40 40 40 40 40 40 40 59 39 39 39 39 39 39 39 39 39 58 39 39 39 39 39 39 39 39 59 39 39 39 39 39 39 39 39 39 39 59 58 39 39 39 39 39 59 40 40 40 40 40 40 40 40 40 40 40 40 40 
40 40 40 40 40 40 40 40 40 40 40 40 40 40 40 40 40 40 40 40 40 40 40 40 40 40 40 40 40 40 40 40 40 40 40 40 40 40 40 40 40 40 59 40 58 40 40 40 40 39 39 39 39 39 39 39 39 39 39 39 39 54 54 54 54 54 54 54 54 54 54 54 54 54 54 54 54 60 39 39 39 39 39 39 39 39 39 40 58 40 59 59 40 40 40 40 40 40 40 40 
40 40 40 40 40 40 40 40 40 40 40 40 40 40 40 40 40 40 40 40 40 40 40 40 40 40 40 40 40 40 40 40 40 40 59 59 40 40 40 40 40 40 40 40 40 40 40 40 39 39 39 39 39 39 58 39 39 61 54 54 45 1 1 1 1 1 1 1 1 1 1 1 1 1 1 1 1 46 54 54 54 60 39 39 39 39 39 39 40 40 40 59 40 40 40 40 40 40 40 40 
40 40 40 40 40 40 40 40 40 40 40 40 40 40 40 40 40 40 40 40 40 40 40 40 40 40 40 40 40 40 40 40 40 40 40 40 40 40 40 40 40 40 58 40 40 40 39 39 39 39 59 39 39 61 54 54 54 45 1 1 1 1 1 10 1 1 1 1 1 1 1 1 1 1 1 1 1 1 1 1 1 46 54 60 39 39 39 39 39 40 40 40 40 40 40 40 40 40 40 40 
40 40 40 40 40 40 40 40 40 40 40 40 40 40 40 40 40 40 40 40 40 40 40 40 40 40 40 40 40 59 40 40 40 40 40 40 58 40 40 40 59 40 40 39 39 39 39 61 54 54 54 54 54 45 1 1 1 1 1 1 1 1 1 1 1 1 1 1 1 1 1 20 24 1 1 2 1 1 1 1 1 1 1 52 39 59 59 39 39 39 40 40 40 40 40 40 40 40 40 40 
40 40 40 40 40 40 40 40 40 40 40 40 40 40 40 40 40 40 40 40 40 40 40 40 40 40 40 40 40 40 40 40 40 59 40 40 40 40 59 59 40 40 39 39 39 61 54 45 1 1 1 1 1 1 1 1 1 1 1 1 1 1 1 1 1 1 1 1 1 1 1 16 36 1 1 1 1 1 1 1 1 1 1 47 60 39 39 39 39 39 40 40 40 58 40 40 40 40 40 40 
40 40 40 40 40 40 40 40 40 40 40 40 40 40 40 40 40 40 40 40 40 40 40 40 40 40 40 40 40 40 40 40 40 40 40 40 40 40 40 40 40 39 39 61 54 45 1 1 1 1 1 1 1 1 1 1 1 9 1 1 1 1 2 1 1 1 1 1 1 1 1 16 35 1 1 1 1 1 1 9 1 1 1 1 52 39 39 39 39 39 40 40 40 40 40 40 40 40 40 40 
40 40 40 40 40 40 40 40 40 40 40 40 40 40 40 40 40 40 40 40 40 40 40 40 40 40 40 40 40 40 40 40 40 40 40 40 40 39 39 39 39 58 61 45 1 1 1 1 1 1 1 1 1 1 1 1 1 1 1 1 1 1 1 1 1 1 1 1 1 1 1 17 35 1 1 1 1 1 1 1 1 1 1 1 47 60 39 39 59 39 39 40 40 40 40 40 40 40 40 40 
40 40 40 40 40 40 40 40 40 40 40 40 40 40 40 40 40 40 40 40 40 40 40 40 40 40 40 40 40 58 40 40 40 40 40 39 39 58 39 61 54 54 45 1 1 1 1 1 1 1 6 2 1 1 1 1 1 1 1 1 1 1 1 1 1 1 1 1 1 1 20 11 36 1 1 1 1 1 1 1 1 1 2 1 1 52 39 39 39 39 39 39 40 40 40 40 40 40 40 40 
40 40 40 40 40 40 40 40 40 40 40 40 40 40 40 40 40 40 40 40 40 40 40 40 40 40 40 40 40 40 40 40 59 39 39 39 39 61 54 45 1 1 1 1 1 1 10 1 1 1 1 1 1 1 20 33 33 33 31 31 31 32 31 31 33 31 33 32 31 33 11 22 35 1 1 1 1 1 1 1 1 1 1 1 1 47 60 39 39 58 39 39 40 40 40 40 40 40 40 40 
40 40 40 40 40 40 40 40 40 40 40 40 40 40 40 40 40 40 40 40 40 40 40 40 40 40 40 40 40 40 40 40 40 39 58 39 61 45 1 1 1 1 1 1 1 1 1 1 1 1 1 1 1 1 16 22 11 13 14 15 14 14 14 13 14 14 14 14 14 15 14 14 23 1 1 1 1 1 1 6 1 1 1 1 1 1 47 60 39 39 39 39 59 40 40 40 40 58 40 40 
40 40 40 40 40 40 40 40 40 40 40 40 40 40 40 40 40 40 40 40 40 40 40 40 40 40 40 40 40 40 40 40 39 39 39 61 45 1 1 1 1 1 1 6 1 1 1 2 1 1 1 1 1 1 16 11 23 1 1 1 1 1 1 1 1 1 1 1 1 1 1 1 1 1 1 1 1 1 1 1 1 1 1 1 1 1 1 47 60 39 39 39 59 40 40 40 40 40 40 40 
40 40 40 40 40 40 40 40 40 40 40 40 40 40 40 40 40 40 40 40 40 40 40 40 40 40 40 40 40 59 40 40 58 39 61 45 1 1 1 1 9 1 1 1 1 1 1 1 1 1 1 1 1 1 19 36 1 1 1 1 1 1 1 1 1 1 1 1 1 1 1 1 10 1 1 1 1 1 1 1 1 1 1 1 1 1 1 1 52 39 39 39 39 40 40 40 40 40 40 40 
40 40 40 40 40 40 40 40 40 40 40 40 40 40 40 40 40 40 40 40 40 40 40 40 40 40 40 40 40 40 40 39 39 39 51 1 1 1 1 1 1 1 1 1 1 1 1 1 1 1 1 1 1 1 16 35 1 1 1 1 9 1 1 1 1 1 1 1 1 4 1 1 1 1 1 1 2 1 1 1 1 1 1 1 1 1 1 1 52 39 39 39 39 39 39 40 40 40 40 40 
40 40 40 40 40 40 40 40 40 40 40 40 40 40 40 40 40 40 40 40 40 40 40 40 40 40 59 40 40 40 40 39 39 61 45 1 1 1 1 1 1 1 1 1 1 1 1 1 1 1 1 1 1 1 16 35 1 1 1 1 1 1 1 1 1 1 1 7 8 1 2 1 1 1 1 1 1 1 1 1 1 1 1 10 1 1 1 1 52 39 39 39 39 39 39 40 40 40 40 40 
40 40 40 40 40 40 40 40 40 40 40 40 40 40 40 40 40 40 40 40 40 40 59 40 40 40 40 40 58 40 40 59 39 51 1 1 1 1 1 1 1 1 1 1 1 1 1 1 1 1 10 1 1 1 16 36 1 1 1 1 1 1 1 1 6 1 3 1 4 6 5 8 1 1 1 1 1 1 1 1 1 1 1 1 1 1 1 1 52 39 39 39 59 39 39 40 40 40 40 40 
40 40 40 40 40 40 40 40 40 40 40 40 40 40 40 40 40 40 40 40 40 40 40 40 40 40 40 40 40 40 40 39 39 51 1 1 1 1 1 1 1 8 10 8 3 8 1 1 1 1 1 1 1 1 16 35 1 1 1 1 1 1 1 1 1 1 8 2 7 4 3 1 1 1 1 1 1 1 1 1 1 1 1 1 1 1 1 1 52 39 39 39 39 39 39 40 40 40 40 40 
40 40 40 40 40 40 40 40 40 40 40 40 40 40 40 40 40 40 40 40 40 40 40 40 40 40 58 40 40 40 39 39 39 51 1 1 10 1 2 1 8 6 7 2 8 4 2 1 1 1 1 1 1 1 16 35 1 1 2 1 1 1 1 1 1 1 5 6 3 2 1 7 1 1 1 1 1 1 1 1 1 1 1 1 1 1 1 1 52 39 39 39 39 39 59 40 40 40 40 40 
40 40 40 40 40 40 40 40 40 40 40 40 40 40 40 40 40 40 40 40 40 40 40 40 40 40 40 40 40 40 39 58 39 51 1 1 1 1 1 1 9 8 5 8 9 5 7 1 1 1 1 1 1 1 19 35 1 1 1 1 1 1 1 1 1 1 7 4 8 5 6 4 1 1 1 1 1 1 1 1 1 1 1 1 1 1 1 1 52 39 58 39 39 39 39 40 40 40 40 40 
40 40 40 40 40 40 40 40 40 40 40 40 40 40 40 40 40 40 40 40 40 40 40 40 40 40 40 59 40 39 39 39 39 51 1 1 1 1 1 1 8 3 8 6 8 8 6 1 1 1 1 1 1 1 17 35 1 1 1 1 1 1 1 1 1 1 1 2 1 1 1 6 1 1 1 1 1 2 1 1 1 1 57 53 53 53 53 53 63 39 39 39 39 39 39 40 40 40 40 40 
40 40 40 40 40 40 40 40 40 40 40 40 40 40 40 40 40 40 40 40 40 40 40 40 40 40 40 40 40 59 39 39 39 51 1 1 1 6 1 1 2 8 10 8 3 5 8 1 1 1 1 1 1 1 16 36 1 1 1 1 1 1 10 1 1 1 1 1 1 1 1 1 1 1 1 1 1 1 1 1 57 53 63 39 61 54 54 54 60 39 39 39 39 39 39 40 40 40 40 40 
40 40 40 40 40 40 40 40 40 40 40 40 40 40 40 40 40 40 40 40 40 40 40 40 40 40 40 40 58 39 39 39 61 45 1 1 1 1 1 1 1 4 7 6 8 1 1 1 6 1 1 1 1 1 16 35 1 1 1 1 1 1 1 1 1 1 1 1 1 1 1 1 1 1 9 1 1 1 1 57 63 61 54 54 45 1 1 1 52 39 39 59 39 39 39 39 40 40 40 40 
40 40 40 40 40 40 40 40 40 40 40 40 40 40 40 40 40 40 58 40 40 40 40 58 40 40 40 39 39 39 39 39 51 1 1 1 1 1 1 1 1 1 1 1 1 1 1 1 1 1 1 1 1 1 17 35 1 1 1 1 1 1 1 1 1 1 1 1 1 1 1 1 1 1 1 1 57 53 53 63 61 45 1 1 1 1 1 1 52 39 39 59 39 39 39 39 40 40 40 40 
40 40 40 40 40 40 40 40 40 40 40 40 40 40 40 40 40 40 40 59 40 40 40 40 39 39 39 39 39 61 54 60 62 53 43 1 1 1 1 2 1 1 1 1 1 1 1 1 1 2 1 1 1 1 16 35 1 1 1 1 1 1 1 1 1 1 1 1 1 1 1 1 1 57 53 53 63 59 61 54 45 1 1 1 1 1 1 1 52 39 39 39 39 39 39 39 40 40 40 40 
40 40 40 40 40 40 40 40 40 40 40 40 40 40 40 40 40 40 40 40 40 39 39 39 59 39 39 39 61 45 1 47 60 59 62 43 1 1 1 1 1 1 1 1 1 1 1 1 1 1 1 1 9 1 19 36 1 1 1 1 1 1 1 1 1 57 53 53 53 53 53 53 53 63 39 61 54 54 45 1 1 1 2 1 1 1 10 1 52 39 39 39 39 39 39 39 40 40 40 58 
40 40 40 40 40 40 40 40 40 40 40 40 40 40 40 40 40 40 40 40 39 39 58 39 39 61 54 54 45 1 1 1 47 54 60 62 43 1 1 1 1 9 1 1 1 1 1 1 1 1 1 1 1 1 16 35 1 1 1 1 1 1 57 53 53 63 61 54 54 54 54 54 54 54 54 45 1 1 1 1 1 1 1 1 1 1 1 1 52 39 59 58 39 39 39 39 39 40 40 40 
40 40 40 40 40 40 40 40 40 40 40 40 40 40 40 40 58 40 40 39 39 39 61 54 54 45 1 1 1 1 1 1 1 1 47 60 62 43 1 1 1 1 1 1 1 1 1 1 1 1 1 1 1 1 18 36 1 1 1 1 57 53 63 61 54 54 45 1 1 1 1 1 1 1 1 1 1 1 1 9 1 1 1 1 1 1 1 1 47 60 39 39 39 39 39 39 39 40 40 40 
40 40 40 40 40 40 40 40 40 40 40 40 40 40 40 40 40 40 40 39 39 58 51 1 1 1 1 1 1 1 1 1 1 1 1 47 60 62 43 1 1 1 1 1 1 1 10 1 1 1 1 1 1 1 17 35 1 1 1 57 63 61 54 45 1 1 1 1 1 1 1 1 1 1 1 1 1 1 1 1 1 1 1 6 1 1 1 1 1 52 39 39 39 39 39 39 39 40 40 40 
40 40 40 40 40 40 40 40 40 40 40 40 40 40 40 40 59 59 40 39 39 61 45 1 1 1 1 1 1 10 1 6 1 1 9 1 47 60 62 53 43 1 1 1 1 1 1 1 1 1 1 1 1 1 16 36 1 57 53 63 61 45 1 1 1 1 1 10 1 6 1 1 1 1 1 1 1 1 1 1 1 1 1 1 1 1 1 1 1 52 39 39 39 39 39 39 39 40 40 40 
40 40 40 40 40 40 40 40 40 40 40 40 40 40 40 40 40 40 39 39 39 51 1 1 1 1 1 1 1 20 33 24 1 1 1 1 1 47 60 59 62 43 1 1 1 1 1 1 1 1 1 1 1 1 18 23 57 63 58 61 45 1 1 1 1 1 1 1 1 1 1 1 1 1 1 10 1 1 1 1 1 1 1 1 1 1 1 1 1 47 60 39 39 39 39 39 39 40 40 40 
40 40 40 40 40 40 40 40 40 40 40 40 40 40 59 40 40 39 39 58 39 51 1 1 1 1 1 6 2 18 22 35 1 1 1 1 1 1 47 54 60 62 43 1 1 2 1 1 1 1 1 1 57 43 28 1 52 61 54 45 1 1 1 1 1 1 1 1 1 1 1 1 1 1 1 1 1 6 1 1 1 1 1 1 1 1 1 1 1 1 52 39 39 39 39 39 39 40 40 40 
40 40 40 40 40 40 40 40 40 40 40 40 40 40 40 40 40 39 39 58 39 51 1 1 1 1 1 1 1 21 12 23 1 1 1 1 1 1 1 1 47 60 51 1 1 1 1 1 1 1 57 53 63 51 1 1 47 45 1 1 1 1 1 1 9 1 1 1 1 1 1 1 1 1 1 1 1 1 1 1 1 1 1 1 1 1 9 1 1 1 52 39 39 39 39 39 39 39 40 40 
40 40 40 40 40 40 40 40 40 40 40 40 40 40 40 40 58 39 39 39 39 51 1 1 9 1 1 1 1 1 1 1 1 1 1 1 1 1 1 1 1 52 39 43 1 1 1 1 57 53 63 61 54 45 1 1 9 1 1 1 1 1 1 1 1 1 1 1 1 1 1 1 1 9 1 1 1 1 1 1 1 2 1 1 1 1 1 1 1 1 52 39 39 39 39 39 39 39 40 40 
40 40 40 40 40 40 40 40 40 40 40 40 40 40 40 40 40 39 58 39 61 45 1 1 1 1 1 1 6 1 1 1 1 1 1 1 1 1 1 1 1 47 60 62 43 1 1 57 63 61 54 45 1 1 1 1 1 1 1 1 1 1 1 1 1 6 1 1 1 1 1 1 1 1 1 1 1 1 1 1 1 1 1 1 1 1 1 1 1 1 52 39 39 39 39 39 39 40 40 40 
40 40 40 40 40 40 40 40 40 40 40 40 40 40 40 40 40 39 39 39 51 1 1 1 1 10 1 1 1 1 1 1 1 1 1 1 6 1 1 10 1 1 47 39 62 53 53 63 61 45 1 1 1 1 1 1 1 1 1 1 1 1 1 1 1 2 1 1 1 1 1 1 1 1 1 1 1 1 1 1 1 1 1 1 1 1 1 1 1 1 52 39 39 39 58 39 39 40 40 40 
40 40 40 40 40 40 40 40 40 40 40 40 40 40 58 40 40 39 39 39 51 1 1 1 1 1 1 1 1 1 1 1 1 1 1 1 1 1 1 1 1 1 1 47 60 39 59 61 45 1 1 1 1 2 1 1 1 1 1 1 1 1 1 1 1 1 1 1 1 1 1 1 1 1 1 1 1 10 1 1 1 1 1 1 1 1 1 6 1 1 52 39 39 39 39 39 39 40 40 40 
40 40 40 40 40 40 40 40 40 40 40 40 40 40 40 40 40 39 39 39 51 1 1 1 1 1 1 1 1 1 1 1 1 1 1 1 1 1 1 1 1 1 1 1 52 58 39 51 1 1 1 1 1 1 6 1 1 1 1 1 10 1 1 1 1 1 1 1 1 2 1 1 1 1 1 1 1 1 1 1 1 1 1 1 1 1 1 1 1 1 52 39 39 39 39 39 39 40 40 40 
40 40 40 40 40 40 40 40 40 40 40 40 40 40 40 59 40 39 39 39 62 43 1 1 1 1 1 1 1 1 1 1 1 1 2 1 1 1 1 1 1 1 1 1 47 54 60 62 43 1 1 9 1 1 1 1 1 1 1 1 1 1 1 1 1 1 1 1 1 1 1 1 1 1 1 1 1 1 1 1 1 1 2 1 1 1 1 1 1 1 52 39 39 39 39 39 39 40 40 40 
40 40 40 40 40 40 40 40 40 40 40 40 40 40 40 40 40 39 39 58 39 51 1 1 1 1 1 1 1 1 9 1 1 1 1 1 1 1 1 1 1 1 1 1 1 1 47 60 62 43 1 1 1 1 1 1 1 1 1 1 1 1 1 9 1 1 1 1 1 1 1 1 1 1 1 1 1 1 1 1 1 6 1 1 1 1 1 1 1 1 52 39 39 39 39 39 39 40 58 40 
40 40 40 40 40 40 40 40 59 40 40 40 40 40 58 40 39 39 39 39 61 45 1 1 1 1 1 1 1 1 1 1 1 1 1 1 10 1 1 1 1 1 1 1 1 1 1 47 60 62 53 43 1 1 1 1 1 1 6 1 1 1 1 1 1 1 1 1 1 1 1 1 1 1 6 1 1 1 1 1 1 1 1 1 1 1 10 1 1 57 63 39 39 39 39 39 40 40 40 40 
40 40 40 40 40 40 40 40 40 40 40 40 40 40 40 39 39 39 39 39 51 1 1 1 1 1 1 1 1 1 1 1 1 1 1 1 1 1 1 1 1 1 1 1 1 1 1 1 47 54 60 62 53 43 1 1 1 1 1 1 1 1 1 1 1 1 1 1 10 1 1 1 1 1 1 1 1 1 9 1 1 1 1 1 1 1 1 1 57 63 39 39 39 39 39 39 40 40 40 40 
40 40 40 40 40 40 40 40 40 40 40 40 40 40 40 58 39 39 61 54 45 1 1 1 1 6 1 1 1 1 1 1 1 1 1 1 1 1 1 1 1 1 1 1 1 2 1 1 1 1 47 60 39 62 53 43 1 1 1 1 1 1 1 57 53 43 1 1 1 1 1 1 1 1 1 1 1 1 1 1 1 1 1 1 1 1 1 1 52 39 39 58 59 39 39 39 40 40 40 40 
40 40 40 40 40 40 40 40 40 40 40 40 40 40 40 39 39 39 51 1 1 1 1 1 1 1 1 1 1 1 1 1 1 6 1 1 1 1 1 1 9 1 1 1 1 1 1 1 1 1 1 47 54 54 60 62 53 53 53 53 53 53 53 63 58 62 53 53 53 53 53 53 53 53 53 53 43 1 1 1 1 1 1 1 1 1 1 1 52 39 39 39 39 39 39 40 40 40 40 40 
40 40 40 40 40 40 40 40 40 40 40 40 40 40 40 39 39 61 45 1 1 1 1 1 1 1 1 1 1 1 1 1 1 1 1 1 1 1 1 1 1 1 1 1 1 1 1 1 10 1 1 1 1 1 47 60 39 59 39 61 54 54 54 54 54 54 54 54 54 54 54 54 54 54 60 59 62 43 1 1 57 53 43 1 1 1 1 1 52 39 39 39 39 40 40 40 40 40 40 40 
40 40 40 40 40 40 40 40 40 40 40 40 40 40 58 39 39 51 1 1 1 1 1 1 1 1 2 1 1 1 1 1 1 1 1 1 1 1 1 1 1 1 1 1 1 1 1 1 1 1 1 1 1 1 1 46 60 39 61 45 1 1 1 1 1 1 1 1 1 1 1 1 1 1 47 54 54 45 1 1 47 60 62 53 43 1 1 1 52 39 39 39 39 59 40 40 40 40 40 40 
40 40 40 40 40 40 40 40 40 40 59 59 40 40 39 39 39 51 1 1 10 1 1 1 1 1 1 1 1 1 10 6 1 1 1 2 1 1 1 1 1 1 1 6 1 1 1 1 1 1 1 1 1 1 1 1 46 60 51 1 1 1 1 1 1 1 9 1 1 1 1 1 1 1 1 1 1 1 1 1 1 47 54 60 62 53 53 53 63 39 39 39 40 59 40 40 40 40 40 40 
40 40 40 40 40 40 40 40 40 40 40 40 40 40 39 39 39 51 1 1 1 1 1 1 1 1 1 1 1 1 1 1 1 1 1 1 1 1 1 1 1 1 1 1 1 1 1 1 1 1 1 1 1 1 1 1 1 52 62 43 1 1 10 1 1 1 1 1 6 1 10 1 1 1 1 1 1 10 1 1 1 1 1 47 54 54 60 59 39 39 39 39 40 40 40 40 40 40 40 40 
40 40 40 40 40 40 40 40 40 40 40 40 40 39 39 39 39 51 1 1 1 6 1 1 1 1 1 1 1 1 1 1 1 1 1 1 1 1 1 1 1 1 1 1 1 1 2 1 1 1 1 1 9 1 1 1 1 46 60 51 1 1 1 1 1 1 1 2 1 1 1 1 1 9 1 1 1 1 1 1 1 1 1 1 1 1 47 60 39 39 39 39 40 40 40 40 40 40 40 40 
40 40 40 40 40 40 40 40 40 40 40 40 40 39 39 39 39 62 43 1 1 1 1 1 1 1 1 1 1 1 1 1 1 1 1 1 1 1 1 1 1 1 1 1 1 1 1 1 1 1 1 1 1 1 1 1 1 1 52 51 1 1 1 1 6 1 1 1 1 1 1 1 1 1 1 1 1 6 1 1 2 1 1 1 1 1 1 52 39 39 39 39 40 40 40 40 58 40 40 40 
40 40 40 40 40 40 40 40 40 40 40 40 58 59 39 39 39 58 51 1 1 1 1 1 1 1 9 1 1 1 1 1 1 1 1 6 1 1 1 1 1 1 1 1 1 1 1 1 6 1 1 1 1 1 1 1 1 1 52 51 1 1 2 1 1 1 1 1 1 1 1 1 1 1 1 2 1 1 1 1 1 1 1 1 9 1 1 52 39 39 39 39 40 40 40 40 40 40 40 40 
40 40 40 40 40 40 40 40 40 40 40 40 40 39 39 39 39 39 51 1 1 1 1 1 1 1 1 1 1 1 1 1 1 1 1 1 1 1 1 1 10 1 1 1 1 1 1 1 1 1 1 1 1 1 1 1 10 1 52 62 43 1 1 1 9 1 1 1 10 1 1 1 1 1 9 1 1 1 1 1 1 1 6 1 1 1 1 52 58 39 59 40 40 40 40 40 40 40 40 40 
40 40 40 40 40 40 40 40 40 40 40 40 40 39 39 39 39 39 62 43 1 1 1 1 1 1 1 1 1 1 1 1 1 1 1 1 1 1 1 1 1 1 1 1 1 1 1 1 1 1 1 1 1 1 1 1 1 1 46 60 62 43 1 1 1 1 1 1 1 1 6 1 1 1 1 1 1 1 10 1 1 1 1 1 1 1 1 52 39 39 39 40 40 40 40 40 40 40 40 40 
40 40 40 40 40 40 40 40 40 40 40 40 40 40 39 39 39 39 39 51 1 1 1 1 1 1 6 1 1 1 1 1 1 1 1 1 1 1 1 1 1 1 9 1 1 1 1 1 1 1 1 1 1 6 1 1 1 1 1 52 61 45 1 1 1 1 1 1 1 1 1 1 1 1 1 1 1 1 1 1 1 1 1 1 1 1 1 52 39 39 39 40 40 40 40 40 40 40 40 40 
40 40 40 40 40 40 40 40 40 40 40 40 40 40 39 39 39 39 39 51 1 1 1 1 1 2 1 1 1 1 10 1 1 1 1 1 6 1 1 1 1 1 1 1 1 1 1 1 1 1 1 1 1 1 1 1 1 1 1 47 45 1 1 1 1 1 1 6 1 1 1 1 1 1 1 1 1 2 1 1 1 1 1 1 1 1 57 63 39 39 39 40 40 40 40 40 40 40 40 40 
40 40 40 40 40 40 40 40 40 40 40 40 40 58 39 59 39 39 39 62 43 1 1 1 1 1 1 1 1 1 1 1 1 1 1 1 1 1 1 1 1 1 1 1 1 1 1 1 1 10 1 1 1 1 1 1 1 1 1 1 1 1 1 1 1 10 1 1 1 1 1 1 1 10 1 6 1 1 1 1 1 1 1 1 1 57 63 39 39 39 39 40 40 40 40 40 40 40 40 40 
40 40 40 40 40 40 59 40 40 40 40 40 40 40 39 39 39 39 39 39 62 53 43 1 1 1 1 1 1 1 1 1 1 1 1 1 1 1 1 1 1 1 1 1 6 1 1 1 1 1 1 1 1 1 1 1 1 1 1 1 1 1 1 1 1 1 1 1 1 1 1 1 1 1 1 1 1 1 1 1 57 53 53 53 53 63 39 39 39 39 40 40 59 40 40 40 40 40 40 40 
40 40 40 40 40 40 40 40 40 40 40 40 40 40 40 39 39 39 39 39 39 39 62 43 1 1 1 1 57 53 53 53 53 43 1 1 1 1 1 1 1 1 1 1 1 1 1 1 1 1 1 1 1 1 1 1 1 1 1 1 57 53 43 1 1 1 1 1 1 2 1 1 1 1 1 1 57 53 53 53 63 39 39 39 39 39 58 39 39 39 40 40 40 40 40 40 40 40 40 40 
40 40 40 40 40 40 40 40 40 40 40 40 40 40 40 40 39 39 39 39 58 39 39 62 43 1 1 57 39 39 39 39 39 62 53 43 1 1 1 1 1 1 1 1 1 1 1 1 1 1 1 1 1 1 1 1 1 1 1 1 46 60 62 43 1 1 1 1 1 1 1 1 1 1 1 57 63 39 39 39 39 39 39 39 39 39 39 39 39 39 40 40 40 40 40 40 40 40 40 40 
40 40 40 40 40 40 40 40 40 40 40 40 58 58 40 40 40 40 39 39 39 39 39 39 62 53 53 63 39 39 39 39 39 39 39 62 43 1 1 1 9 1 1 1 1 1 1 6 1 1 1 1 1 1 1 1 9 1 1 1 1 52 39 51 1 1 1 9 1 1 6 1 57 53 53 63 39 39 39 39 39 39 39 39 39 59 39 39 39 40 40 40 40 40 40 40 40 40 40 40 
40 40 40 40 40 40 40 40 40 40 40 40 40 40 40 40 40 58 40 40 40 39 39 58 39 39 39 39 39 39 58 39 39 39 39 39 51 1 1 1 1 1 1 1 1 1 1 6 1 1 1 1 1 1 1 1 1 1 1 1 1 46 60 62 43 1 1 1 1 1 57 53 63 39 39 39 59 39 39 58 39 39 39 39 39 59 39 39 39 40 40 40 40 40 40 40 40 40 40 40 
40 40 40 40 40 40 40 40 40 40 40 40 40 40 40 40 40 58 40 40 40 40 39 39 39 39 39 39 59 40 40 40 39 39 39 39 62 43 1 1 1 1 10 1 1 1 2 1 1 1 1 1 1 1 10 1 1 6 1 1 1 1 52 58 51 1 1 1 57 53 63 39 39 39 39 39 39 39 39 39 39 39 39 39 39 39 58 39 40 40 40 40 40 40 40 40 40 40 40 40 
40 40 40 40 40 40 40 40 40 40 40 40 40 40 40 40 40 40 40 40 40 40 40 40 40 40 40 40 40 40 40 40 40 39 59 39 39 62 43 1 1 1 1 1 1 1 1 1 1 1 1 1 1 1 1 1 1 1 1 1 1 1 52 39 62 53 53 53 63 39 39 39 39 39 39 39 39 39 39 39 39 39 39 39 39 40 40 40 40 40 40 40 40 40 40 40 40 40 40 40 
40 40 40 40 40 40 40 40 40 40 40 40 40 40 40 40 40 40 40 40 40 40 40 40 40 40 40 40 40 40 40 40 40 58 39 39 39 39 62 53 43 1 1 1 1 1 1 1 57 53 53 53 53 53 53 53 53 53 53 53 53 53 63 39 39 39 39 39 39 39 39 39 39 39 39 39 39 39 39 39 39 39 39 40 40 40 40 40 59 40 40 40 40 40 40 40 40 40 40 40 
40 40 40 40 40 40 40 40 40 40 40 40 40 40 40 40 40 40 40 40 59 40 40 40 40 40 40 40 40 40 40 40 40 40 40 39 39 39 39 39 62 53 53 53 53 53 53 53 63 39 39 39 39 39 39 39 39 39 39 39 39 39 39 39 39 39 39 39 39 58 59 59 39 39 39 39 39 40 40 59 40 40 40 40 40 40 40 40 40 40 40 40 40 40 40 40 40 40 40 40 
40 40 40 40 40 40 40 40 40 40 40 40 40 40 40 40 40 40 40 40 40 40 40 40 40 40 40 40 40 40 40 40 40 40 40 39 39 58 39 39 39 39 39 39 39 39 39 39 39 59 39 58 39 39 39 39 39 39 39 39 39 39 58 39 39 39 39 39 39 39 39 39 39 39 39 40 40 40 40 40 40 40 40 40 40 40 40 40 40 40 40 40 40 40 40 40 40 40 40 40 
40 40 40 40 40 40 40 40 40 40 40 40 40 40 40 40 40 40 40 40 58 40 40 40 40 40 40 40 58 40 40 40 40 40 40 40 40 39 39 39 39 39 39 39 39 39 39 39 39 39 39 39 39 39 39 39 39 39 39 39 39 39 39 59 39 39 39 39 39 39 39 39 40 40 40 40 40 40 40 40 40 40 40 40 40 40 40 58 40 40 40 40 40 40 58 40 40 40 40 40 
40 40 40 40 40 40 40 40 40 40 40 40 40 40 40 40 40 40 40 40 40 40 40 40 40 40 59 40 40 40 40 40 40 40 40 40 40 40 40 40 58 39 39 39 39 39 39 39 39 39 39 39 39 39 39 39 39 39 39 39 40 40 40 40 40 40 40 40 40 40 40 40 40 40 40 58 40 40 40 40 40 40 40 40 40 40 40 40 40 40 40 40 40 40 40 40 40 40 40 40 
40 40 40 40 40 40 40 40 40 40 40 40 40 40 40 40 40 40 59 40 40 40 40 40 40 40 40 40 40 40 40 40 40 40 40 40 40 40 40 40 40 40 40 40 40 40 40 40 40 40 59 40 40 40 40 40 40 40 40 40 40 40 40 40 40 40 40 40 40 40 40 40 40 40 40 40 40 40 40 40 40 40 40 40 40 40 40 40 40 40 40 40 40 40 40 40 40 40 40 40 
40 40 40 40 40 40 40 40 40 40 40 40 40 40 40 40 40 40 40 40 40 40 40 40 40 40 40 40 40 40 40 40 58 40 59 40 40 59 40 40 40 40 40 40 40 40 40 40 40 40 40 58 40 40 40 40 40 40 40 40 40 40 40 59 40 40 40 40 40 40 40 40 40 40 40 40 40 40 40 40 40 40 40 40 40 40 40 40 40 40 40 40 40 40 40 40 40 40 40 40 
40 40 40 40 40 40 40 40 40 40 40 40 40 40 40 40 40 40 40 40 40 40 40 40 40 40 40 40 40 40 40 40 40 40 58 40 40 40 40 40 40 40 40 40 40 40 40 40 40 40 40 40 40 40 40 40 40 40 40 40 40 40 40 59 40 40 40 40 40 58 40 40 59 40 40 40 40 40 40 40 59 40 40 40 40 40 40 40 40 40 40 40 40 40 40 40 40 40 40 40 
40 40 40 40 40 40 40 40 40 40 40 40 40 40 40 40 40 40 40 40 40 40 40 40 40 40 40 40 40 40 40 40 40 40 40 40 40 40 40 40 58 40 40 40 40 40 40 40 40 40 40 40 40 40 40 40 40 40 40 40 40 58 58 40 40 40 40 40 40 40 40 40 40 40 40 40 40 40 40 40 59 40 40 40 40 40 40 40 40 40 40 40 40 40 40 40 40 40 40 40 
40 40 40 40 40 40 40 40 40 40 40 40 40 40 40 40 40 40 40 40 40 40 40 40 40 40 40 40 40 40 40 40 40 40 40 40 40 40 40 40 40 40 40 40 40 40 40 40 40 40 40 40 40 40 40 40 40 40 40 40 40 40 40 40 40 40 40 40 40 40 40 40 58 40 40 40 40 40 40 40 40 40 40 40 40 40 40 40 40 40 40 40 40 40 40 40 40 40 40 40 
40 40 40 40 40 40 40 40 40 40 40 40 40 40 40 40 40 40 40 40 40 40 40 40 40 40 40 40 40 40 40 40 40 40 40 40 40 40 40 40 40 40 40 40 40 40 40 40 40 40 40 40 40 40 40 58 40 40 40 40 40 40 40 40 40 40 40 40 40 40 40 40 40 40 40 40 40 40 40 40 40 40 40 40 40 40 40 40 40 40 40 40 40 40 40 40 40 40 40 40 
40 40 40 40 40 40 40 40 40 40 40 40 40 40 40 40 40 40 40 40 40 40 40 40 40 40 40 40 40 40 40 40 40 40 40 40 40 40 40 40 40 40 40 40 40 40 40 40 40 40 40 40 40 40 40 58 40 40 40 40 40 40 40 40 40 40 40 40 40 40 40 40 40 40 40 40 40 40 40 40 40 40 40 40 40 40 40 40 40 40 40 40 40 40 40 40 40 40 40 40 
40 40 40 40 40 40 40 40 40 40 40 40 40 40 40 40 40 40 40 40 40 40 40 40 40 40 40 40 40 40 40 40 40 40 40 40 40 40 40 40 40 40 40 40 40 40 40 40 40 40 40 40 40 40 40 40 40 40 40 40 40 40 40 40 40 40 40 40 40 40 40 40 40 40 40 40 40 40 40 40 40 40 40 40 40 40 40 40 40 40 40 40 40 40 40 40 40 40 40 40 
40 40 40 40 40 40 40 40 40 40 40 40 40 40 40 40 40 40 40 40 40 40 40 40 40 40 40 40 40 40 40 40 40 40 40 40 40 40 40 40 40 40 40 40 40 40 40 40 40 40 40 40 40 40 40 40 40 40 40 40 40 40 40 40 40 40 40 40 40 40 40 40 40 40 40 40 40 40 40 40 40 40 40 40 40 40 40 40 40 40 40 40 40 40 40 40 40 40 40 40 
40 40 40 40 40 40 40 40 40 40 40 40 40 40 40 40 40 40 40 40 40 40 40 40 40 40 40 40 40 40 40 40 40 40 40 40 40 40 40 40 40 40 40 40 40 40 40 40 40 40 40 40 40 40 40 40 40 40 40 40 40 40 40 40 40 40 40 40 40 40 40 40 40 40 40 40 40 40 40 40 40 40 40 40 40 40 40 40 40 40 40 40 40 40 40 40 40 40 40 40 
40 40 40 40 40 40 40 40 40 40 40 40 40 40 40 40 40 40 40 40 40 40 40 40 40 40 40 40 40 40 40 40 40 40 40 40 40 40 40 40 40 40 40 40 40 40 40 40 40 40 40 40 40 40 40 40 40 40 40 40 40 40 40 40 40 40 40 40 40 40 40 40 40 40 40 40 40 40 40 40 40 40 40 40 40 40 40 40 40 40 40 40 40 40 40 40 40 40 40 40 
40 40 40 40 40 40 40 40 40 40 40 40 40 40 40 40 40 40 40 40 40 40 40 40 40 40 40 40 40 40 40 40 40 40 40 40 40 40 40 40 40 40 40 40 40 40 40 40 40 40 40 40 40 40 40 40 40 40 40 40 40 40 40 40 40 40 40 40 40 40 40 40 40 40 40 40 40 40 40 40 40 40 40 40 40 40 40 40 40 40 40 40 40 40 40 40 40 40 40 40 
40 40 40 40 40 40 40 40 40 40 40 40 40 40 40 40 40 40 40 40 40 40 40 40 40 40 40 40 40 40 40 40 40 40 40 40 40 40 40 40 40 40 40 40 40 40 40 40 40 40 40 40 40 40 40 40 40 40 40 40 40 40 40 40 40 40 40 40 40 40 40 40 40 40 40 40 40 40 40 40 40 40 40 40 40 40 40 40 40 40 40 40 40 40 40 40 40 40 40 40 
40 40 40 40 40 40 40 40 40 40 40 40 40 40 40 40 40 40 40 40 40 40 40 40 40 40 40 40 40 40 40 40 40 40 40 40 40 40 40 40 40 40 40 40 40 40 40 40 40 40 40 40 40 40 40 40 40 40 40 40 40 40 40 40 40 40 40 40 40 40 40 40 40 40 40 40 40 40 40 40 40 40 40 40 40 40 40 40 40 40 40 40 40 40 40 40 40 40 40 40 
40 40 40 40 40 40 40 40 40 40 40 40 40 40 40 40 40 40 40 40 40 40 40 40 40 40 40 40 40 40 40 40 40 40 40 40 40 40 40 40 40 40 40 40 40 40 40 40 40 40 40 40 40 40 40 40 40 40 40 40 40 40 40 40 40 40 40 40 40 40 40 40 40 40 40 40 40 40 40 40 40 40 40 40 40 40 40 40 40 40 40 40 40 40 40 40 40 40 40 40 
40 40 40 40 40 40 40 40 40 40 40 40 40 40 40 40 40 40 40 40 40 40 40 40 40 40 40 40 40 40 40 40 40 40 40 40 40 40 40 40 40 40 40 40 40 40 40 40 40 40 40 40 40 40 40 40 40 40 40 40 40 40 40 40 40 40 40 40 40 40 40 40 40 40 40 40 40 40 40 40 40 40 40 40 40 40 40 40 40 40 40 40 40 40 40 40 40 40 40 40 
